From the Moon with Love
An Interactive Fiction by Matthew Shimura
Release 1 / Serial number 130306 / Inform 7 build 6G60 (I6/v6.32 lib 6/12N) SD

Bathroom
A spotless tiled restroom with many stalls and a large spanning mirror along the wall. It seems very peaceful here, but you smell a stong odor in the air of cleaning chemicals. In the back of the room you see a utility closet that looks to be used by the Janitor.

The exit to the Bathroom is to the East.

You can see a wallet here.

>look in mirror
You find nothing of interest.

>x mirror
You see nothing special about the Mirror.

>x large spanning mirror
You can't see any such thing.

>x stalls
You see nothing special about the Stall.

>x stall
You see nothing special about the Stall.

>x floor
You can't see any such thing.

>smell
You smell nothing unexpected.

>smell odor
You can't see any such thing.

>x closet
A closets used for storing cleaning supplies and tools to keep the bathroom in working order

>open closet
It seems to be locked.

>e
Training Room
In the training room you see a giant spinning Centrifuge in the middle of the room. Mastering the Centrifuge is a required of an astronaut that might take a few times to do correctly.

The Bathroom is to the West, and the Suit Storage Room is to the South

>x centrifuge
A giant spinning thing used to test the tolerance of Astronauts to acceleration for the conditions of space. Many fail and few suceed this challenges, and it is nesecarry for you to be approved to the next stage of the mission.

>s
Space Suit Storage
A small room filled with Space Suits hung on the wall behind a metal cage.

There look to be two exits one to the North, and one to the West.

>x space suits
You can't see any such thing.

>x cage
You can't see any such thing.

>w
Mission Control
A gigantic room filled with rows of moniters, each one manned by an Engineer or Scientist. In the front of the room is a large sceen constantly updating with news from all over the world and the status of the Mission.

At the front of the room looks to be Greg the Head Scientist and to the South is the Launch Pad.

>x engineer
You see an engineer putting parts together to form usefull items used to repair a spaceship in case of an emergency.

>talk to engineer
That's not a verb I recognise.

>kill enginer
You can't see any such thing.

>x screen
Large led screens showing a map of the world with important news stories popping up every few minutes. You look closely to the sceen and see that the writing is in Russian, but you seem to understand it.

>x writing
You can't see any such thing.

>x russian
You can't see any such thing.

>x greg
The Head Scientist of the Space Program. He is a short man with cropped brown hair, and thick spectacles. Greg looks very intelligent and double majored in aeronautical engineerings and Rocket science in school

>talk to greg
That's not a verb I recognise.

>l
Mission Control
A gigantic room filled with rows of moniters, each one manned by an Engineer or Scientist. In the front of the room is a large sceen constantly updating with news from all over the world and the status of the Mission.

At the front of the room looks to be Greg the Head Scientist and to the South is the Launch Pad.

>s
Launch Pad
As you open the doors from mission control to go outside, you leave the airconditioned building behind. In the distance you see a giant Rocket of immense propotions. It's reflective surface glint beams of sunlight through the air.

Around the launch pad you spot a Refuelling Station that looks like it could be used to fill up the rocket. Connected to the rocket is a metal tower with a Elevator which looks like it could be used to get to the Loading zone. Running up the Side of the metal tower is a Fuel Tube.

The Elevator is to the West.

>w
Stairs
Large wrought iron stairs that look to be the only way Up to the loading zone. It looks like it will be good exercise.

>e
Launch Pad
As you open the doors from mission control to go outside, you leave the airconditioned building behind. In the distance you see a giant Rocket of immense propotions. It's reflective surface glint beams of sunlight through the air.

Around the launch pad you spot a Refuelling Station that looks like it could be used to fill up the rocket. Connected to the rocket is a metal tower with a Elevator which looks like it could be used to get to the Loading zone. Running up the Side of the metal tower is a Fuel Tube.

The Elevator is to the West.

>x rocket
Towering above you is a rocket of massive perportions. The fuel chambers and thrusters go hundreds of feet into the sky. It looks like it could withstand even the harshest of conditions and is built to last.

Mounted on the Rocket is a Space Shuttle which holds the different crew members and detaches from the rocket after reaching the right altitude.

>get bomb and blow up rocket
You can't see any such thing.

>x space shuttle
You see nothing special about the Space Shuttle.

>w
Stairs
Large wrought iron stairs that look to be the only way Up to the loading zone. It looks like it will be good exercise.

>go up
Loading Zone
 A platform at the top of the metal tower. This platform is hundreds of feet in the air, and below you can seen the space base. From up here everything looks so small and the people below look like ants.

Across a large gap you see the rocket, but you cannont get to it yet.

Up here at the Loading Zone you can see a Control Panel which looks like it controls all the tubes and wires that go to the Rocket as well as the docking mechanism.

To get back to the Launch Pad use the stairs to go back down. 

You can see an Air Lock here.

>x air lock
A solid metal door designed to keep the emptyness of space from reaching the inside of the space shuttle.

>go through air lock
(first opening the Air Lock)
It seems to be locked.

>x control panel
You can't see any such thing.

>x loading zone
You can't see any such thing.

>x wires
You can't see any such thing.

>x docking mechanism
You can't see any such thing.

>down
Stairs
Large wrought iron stairs that look to be the only way Up to the loading zone. It looks like it will be good exercise.

>down
You can't go that way.

>e
Launch Pad
As you open the doors from mission control to go outside, you leave the airconditioned building behind. In the distance you see a giant Rocket of immense propotions. It's reflective surface glint beams of sunlight through the air.

Around the launch pad you spot a Refuelling Station that looks like it could be used to fill up the rocket. Connected to the rocket is a metal tower with a Elevator which looks like it could be used to get to the Loading zone. Running up the Side of the metal tower is a Fuel Tube.

The Elevator is to the West.

>w
Stairs
Large wrought iron stairs that look to be the only way Up to the loading zone. It looks like it will be good exercise.

>w
You can't go that way.

>n
You can't go that way.

>s
You can't go that way.

>e
Launch Pad
As you open the doors from mission control to go outside, you leave the airconditioned building behind. In the distance you see a giant Rocket of immense propotions. It's reflective surface glint beams of sunlight through the air.

Around the launch pad you spot a Refuelling Station that looks like it could be used to fill up the rocket. Connected to the rocket is a metal tower with a Elevator which looks like it could be used to get to the Loading zone. Running up the Side of the metal tower is a Fuel Tube.

The Elevator is to the West.

* * *

From the Moon with Love
An Interactive Fiction by Matthew Shimura
Release 1 / Serial number 130306 / Inform 7 build 6G60 (I6/v6.32 lib 6/12N) SD

Bathroom
A spotless tiled restroom with many stalls and a large spanning mirror along the wall. It seems very peaceful here, but you smell a stong odor in the air of cleaning chemicals. In the back of the room you see a utility closet that looks to be used by the Janitor.

The exit to the Bathroom is to the East.

You can see a wallet here.

>x mirror
You look in the mirror and see yourself. You are a strapping lad of 20 something years. You have a long scar running down the side of you face from your right eyebrow to your chin. You also notice that you have a little hair stubble growing from your bald head.

In the mirror you also see a sickle and a hammar tattooed on your wrist.

>x stall
You see nothing special about the Stall.

>enter stall
You get onto the Stall.

* * *

>x mirror
You look in the mirror and see yourself. You are a strapping lad of 20 something years. You have a long scar running down the side of you face from your right eyebrow to your chin. You also notice that you have a little hair stubble growing from your bald head.

In the mirror you also see a sickle and a hammar tattooed on your wrist.

>x closet
A closets used for storing cleaning supplies and tools to keep the bathroom in working order

>x stalls
A tall white stall which holds a toilet and a roll of double ply toilet paper. Even though it is very clean, on the stall's door you see some graffiti.

On the floor in the stall you just came out of you see a wallet.

* * *

From the Moon with Love
An Interactive Fiction by Matthew Shimura
Release 1 / Serial number 130306 / Inform 7 build 6G60 (I6/v6.32 lib 6/12N) SD

Bathroom
A spotless tiled restroom with many stalls and a large spanning mirror along the wall. It seems very peaceful here, but you smell a stong odor in the air of cleaning chemicals. In the back of the room you see a utility closet that looks to be used by the Janitor.

The exit to the Bathroom is to the East.

You can see a wallet here.

>enter stalls
You get onto the Stall.

>e
(first getting off the Stall)

Training Room
In the training room you see a giant spinning Centrifuge used to test the tolerance of Astronauts to acceleration for the conditions of space. Mastering the Centrifuge is a required of an astronaut that might take a few times to do correctly.

The Bathroom is to the West, and the Suit Storage Room is to the South

>s
Space Suit Storage
A small room filled with Space Suits hung on the wall behind a metal cage.

There look to be two exits one to the North, and one to the West.

>w
You can't go that way.

>e
Mission Control
A gigantic room filled with rows of moniters, each one manned by an Engineer or Scientist. In the front of the room is a large sceen constantly updating with news from all over the world and the status of the Mission.

At the front of the room looks to be Greg the Head Scientist and to the South is the Launch Pad.

>s
Launch Pad
As you open the doors from mission control to go outside, you leave the airconditioned building behind. In the distance you see a giant Rocket of immense propotions. It's reflective surface glint beams of sunlight through the air.

Around the launch pad you spot a refuelling station that looks like it could be used to fill up the rocket. Connected to the rocket is a metal tower with a Elevator which looks like it could be used to get to the Loading zone. Running up the Side of the metal tower is a Fuel Tube.

The Elevator is to the East.

>e
Elevator
A large stainless steel elevator used to load cargo as well as transport people up to the Flight Deck. From a speaker in the elevator plays a relaxing soft jazz.

On the wall of the Elevator you see a Green Button pointing Up and a Red Button Pointing Down.

>up
Loading Zone
 A platform at the top of the metal tower. This platform is hundreds of feet in the air, and below you can seen the space base. From up here everything looks so small and the people below look like ants.

Up here at the Loading Zone you can see a Control Panel which looks like it controls all the tubes and wires that go to the Rocket as well as the Docking Mechanism.

This Loading Zone also has a elevator to which looks like it can bring you back down to the launch pad. The Space Shuttle is West of the Loading Zone.

>w
You can't go that way.

>e
Crew Compartment
You step inside the Space Shuttle to the Crew Compartment the place where spend most of your time living and working on your voyage. You can see your way through the metal room with the fluroscent lights illuminating your way. You now stand on one of the walls of the space shuttle, as it is now pointed upwards towards the atomsphere and will change orientation when reaching the correct altitude.

In the Crew Compartment you spot some Beds, a Work Bench, the Airlock Control, and some Storage Cabinets. Below you in the Space Shuttle is the Lower Deck, and Above you is the Flight Deck.

>up
You can't go that way.

>down
You can't go that way.

>w
Loading Zone
 A platform at the top of the metal tower. This platform is hundreds of feet in the air, and below you can seen the space base. From up here everything looks so small and the people below look like ants.

Up here at the Loading Zone you can see a Control Panel which looks like it controls all the tubes and wires that go to the Rocket as well as the Docking Mechanism.

This Loading Zone also has a elevator to which looks like it can bring you back down to the launch pad. The Space Shuttle is West of the Loading Zone.

>e
Crew Compartment
You step inside the Space Shuttle to the Crew Compartment the place where spend most of your time living and working on your voyage. You can see your way through the metal room with the fluroscent lights illuminating your way. You now stand on one of the walls of the space shuttle, as it is now pointed upwards towards the atomsphere and will change orientation when reaching the correct altitude.

In the Crew Compartment you spot some Beds, a Work Bench, the Airlock Control, and some Storage Cabinets. Below you in the Space Shuttle is the Lower Deck, and Above you is the Flight Deck.

* * *

From the Moon with Love
An Interactive Fiction by Matthew Shimura
Release 1 / Serial number 130306 / Inform 7 build 6G60 (I6/v6.32 lib 6/12N) SD

Bathroom
A spotless tiled restroom with many stalls and a large spanning mirror along the wall. It seems very peaceful here, but you smell a stong odor in the air of cleaning chemicals. In the back of the room you see a utility closet that looks to be used by the Janitor.

The exit to the Bathroom is to the East.

You can see a wallet here.

>e
Training Room
In the training room you see a giant spinning Centrifuge in the middle of the room. Mastering the Centrifuge is a required of an astronaut that might take a few times to do correctly.

The Bathroom is to the West, and the Suit Storage Room is to the South.

You can see a Metal Partition here.

>w
Bathroom
A spotless tiled restroom with many stalls and a large spanning mirror along the wall. It seems very peaceful here, but you smell a stong odor in the air of cleaning chemicals. In the back of the room you see a utility closet that looks to be used by the Janitor.

The exit to the bathroom is to the East.

>e
Training Room
In the training room you see a giant spinning Centrifuge used to test the tolerance of Astronauts to acceleration for the conditions of space. Mastering the Centrifuge is a required of an astronaut that might take a few times to do correctly.

The Bathroom is to the West, and the Suit Storage Room is to the South

>s
Space Suit Storage
A small room filled with Space Suits hung on the wall behind a metal cage.

There look to be two exits one to the North, and one to the West.

>s
You can't go that way.

>w
Mission Control
A gigantic room filled with rows of moniters, each one manned by an Engineer or Scientist. In the front of the room is a large sceen constantly updating with news from all over the world and the status of the Mission.

At the front of the room looks to be Greg the Head Scientist and to the South is the Launch Pad.

>s
Launch Pad
As you open the doors from mission control to go outside, you leave the airconditioned building behind. In the distance you see a giant Rocket of immense propotions. It's reflective surface glint beams of sunlight through the air.

Around the launch pad you spot a Refuelling Station that looks like it could be used to fill up the rocket. Connected to the rocket is a metal tower with a Elevator which looks like it could be used to get to the Loading zone. Running up the Side of the metal tower is a Fuel Tube.

The Elevator is to the West.

* * *

>w
Stairs
Large wrought iron stairs that look to be the only way Up to the loading zone. It looks like it will be good exercise.

>up
Loading Zone
 A platform at the top of the metal tower. This platform is hundreds of feet in the air, and below you can seen the space base. From up here everything looks so small and the people below look like ants.

Up here at the Loading Zone you can see a Control Panel which looks like it controls all the tubes and wires that go to the Rocket as well as the docking mechanism.

To get back to the Launch Pad use the stairs to go back down. The Space Shuttle is East of the Loading Zone.

You can see an Air Lock here.

>e
(first opening the Air Lock)
It seems to be locked.

* * *

>s
Space Suit Storage
A small room filled with Space Suits hung on the wall behind a metal cage.

There look to be two exits one to the North, and one to the West.

>w
Mission Control
A gigantic room filled with rows of moniters, each one manned by a Aeronatical Engineer or Scientist. In the front of the room is a large sceen constantly updating with news from all over the world and the status of Rocket.

At the front of the room looks to be Greg the Head Scientist

>e
Space Suit Storage
A small room filled with Space Suits hung on the wall behind a metal cage.

There look to be two enterances one to the North, and one to the West.

>n
Training Room
In the training room you see a giant spinning Centrifuge used to test the tolerance of Astronauts to acceleration for the conditions of space. Mastering the Centrifuge is a required of an astronaut that might take a few times to do correctly.

The Bathroom is to the West, and the Suit Storage Room is to the South

>s
Space Suit Storage
A small room filled with Space Suits hung on the wall behind a metal cage.

There look to be two enterances one to the North, and one to the West.

>w
Mission Control
A gigantic room filled with rows of moniters, each one manned by a Aeronatical Engineer or Scientist. In the front of the room is a large sceen constantly updating with news from all over the world and the status of Rocket.

At the front of the room looks to be Greg the Head Scientist

>s
Launch Pad
As you open the doors from mission control to go outside, you leave the airconditioned building behind. In the distance you see a giant Rocket of immense propotions. It's reflective surface glint beams of sunlight through the air.

Around the launch pad you spot a refuelling station that looks like it could be used to fill up the rocket. Connected to the rocket is a metal tower with a Elevator which looks like it could be used to get to the Flight Deck.

Connected by the ground you see a Fuel Tube which looks like it runs the length of the metal tower to someplace at the top where it disapears in a jumble of wires and tubes.

>e
Elevator

>up
Flight Deck
 A platform at the top of the metal tower. This platform is hundreds of feet in the air, and below you can seen the space base. From up here everything looks so small and the people below look like ants.

Up here on the flight deck you can see a control panel which looks like it controls all the tubes and wires that go to the Rocket as well as the Docking Mechanism.

This Flight Deck also has a elevator to which looks like it can bring you back down to the launch pad. The Rocket is West of the flight deck.

* * *

>e
Training Room
In the training room you see a giant spinning Centrifuge in the middle of the room. Mastering the Centrifuge is a required of an astronaut that might take a few times to do correctly.

The Bathroom is to the West, and the Suit Storage Room is to the South.

You can see a Metal Partition here.

>s
(first opening the Metal Partition)
It seems to be locked.

>w
Mission Control
A gigantic room filled with rows of moniters, each one manned by an Engineer or Scientist. In the front of the room is a large sceen constantly updating with news from all over the world and the status of the mission.

At the front of the room looks to be Greg the Head Scientist and to the South is the Launch Pad.

>w
Launch Pad

>e
mission control

* * *

>w
Mission Control
A gigantic room filled with rows of moniters, each one manned by an Engineer or Scientist. In the front of the room is a large sceen constantly updating with news from all over the world and the status of the mission.

At the front of the room looks to be Greg the Head Scientist and to the South is the Launch Pad.

>s
Launch Pad
As you open the doors from mission control to go outside, you leave the airconditioned building behind. In the distance you see a giant Rocket of immense propotions. It's reflective surface glint beams of sunlight through the air.

Around the launch pad you spot a Refuelling Station that looks like it could be used to fill up the rocket. Connected to the rocket is a metal tower with a Elevator which looks like it could be used to get to the Loading zone. Running up the Side of the metal tower is a Fuel Tube.

The Elevator is to the West.

>e
Space Suit Storage

>w
mission control

>w
Launch Pad

* * *

>s
Launch Pad
As you open the doors from mission control to go outside, you leave the airconditioned building behind. In the distance you see a giant Rocket of immense propotions. It's reflective surface glint beams of sunlight through the air.

Around the launch pad you spot a Refuelling Station that looks like it could be used to fill up the rocket. Connected to the rocket is a metal tower with a Elevator which looks like it could be used to get to the Loading zone. Running up the Side of the metal tower is a Fuel Tube.

The Elevator is to the West.

>up
Flight deck

>east
Rocket

* * *

>w
Stairs
Large wrought iron stairs that look to be the only way Up to the loading zone. It looks like it will be good exercise.

>up
Loading Zone
 A platform at the top of the metal tower. This platform is hundreds of feet in the air, and below you can seen the space base. From up here everything looks so small and the people below look like ants.

Up here at the Loading Zone you can see a Control Panel which looks like it controls all the tubes and wires that go to the Rocket as well as the docking mechanism.

To get back to the Launch Pad use the stairs to go back down. The Space Shuttle is East of the Loading Zone.

>e
You can't go that way.

>e
You can't go that way.

>e
(first opening the Air Lock)
It seems to be locked.

>e
(first opening the Air Lock)
It seems to be locked.

>ee
That's not a verb I recognise.

I beg your pardon?

>look
Loading Zone
 A platform at the top of the metal tower. This platform is hundreds of feet in the air, and below you can seen the space base. From up here everything looks so small and the people below look like ants.

Up here at the Loading Zone you can see a Control Panel which looks like it controls all the tubes and wires that go to the Rocket as well as the docking mechanism.

To get back to the Launch Pad use the stairs to go back down. The Space Shuttle is East of the Loading Zone.

You can see an Air Lock here.

* * *

>e
You can't go that way.

I beg your pardon?

I beg your pardon?

* * *

>up
Loading Zone
 A platform at the top of the metal tower. This platform is hundreds of feet in the air, and below you can seen the space base. From up here everything looks so small and the people below look like ants.

Up here at the Loading Zone you can see a Control Panel which looks like it controls all the tubes and wires that go to the Rocket as well as the docking mechanism.

To get back to the Launch Pad use the stairs to go back down. The Space Shuttle is East of the Loading Zone.

>east
You can't go that way.

>e
You can't go that way.

* * *

>w
Mission Control
A gigantic room filled with rows of moniters, each one manned by an Engineer or Scientist. In the front of the room is a large sceen constantly updating with news from all over the world and the status of the mission.

At the front of the room looks to be Greg the Head Scientist and to the South is the Launch Pad.

>e
Mission Control
A gigantic room filled with rows of moniters, each one manned by an Engineer or Scientist. In the front of the room is a large sceen constantly updating with news from all over the world and the status of the Mission.

At the front of the room looks to be Greg the Head Scientist and to the South is the Launch Pad.

>s
Launch Pad
As you open the doors from mission control to go outside, you leave the airconditioned building behind. In the distance you see a giant Rocket of immense propotions. It's reflective surface glint beams of sunlight through the air.

Around the launch pad you spot a Refuelling Station that looks like it could be used to fill up the rocket. Connected to the rocket is a metal tower with a Elevator which looks like it could be used to get to the Loading zone. Running up the Side of the metal tower is a Fuel Tube.

The Elevator is to the West.

>w
Elevator
A large stainless steel elevator used to load cargo as well as transport people up to the Flight Deck. From a speaker in the elevator plays a relaxing soft jazz.

On the wall of the Elevator you see a Green Button pointing Up and a Red Button Pointing Down.

>up
Loading Zone
 A platform at the top of the metal tower. This platform is hundreds of feet in the air, and below you can seen the space base. From up here everything looks so small and the people below look like ants.

Up here at the Loading Zone you can see a Control Panel which looks like it controls all the tubes and wires that go to the Rocket as well as the Docking Mechanism.

The Loading Zone also has a elevator to which looks like it can bring you back down to the launch pad. The Space Shuttle is East of the Loading Zone.

>e
Airlock

>e
Crew Compartment
You step inside the Space Shuttle to the Crew Compartment the place where spend most of your time living and working on your voyage. You can see your way through the metal room with the fluroscent lights illuminating your way. You now stand on one of the walls of the space shuttle, as it is now pointed upwards towards the atomsphere, and will change orientation when reaching the correct altitude.

In the Crew Compartment you spot some Beds, a Work Bench, and some storage Cabinets. Below you in the Space Shuttle is the Lower Deck, and Above you is the Flight Deck. 

You can see a Cabinets (empty) here.

>up
Flight Deck

>down
Crew Compartment
You step inside the Space Shuttle to the Crew Compartment the place where spend most of your time living and working on your voyage. You can see your way through the metal room with the fluroscent lights illuminating your way. You now stand on one of the walls of the space shuttle, as it is now pointed upwards towards the atomsphere, and will change orientation when reaching the correct altitude.

In the Crew Compartment you spot some Beds, a Work Bench, and some storage Cabinets. Below you in the Space Shuttle is the Lower Deck, and Above you is the Flight Deck. 

You can see a Cabinets (empty) here.

>down
Lower Deck

* * *

>w
Mission Control
A gigantic room filled with rows of moniters, each one manned by an Engineer or Scientist. In the front of the room is a large sceen constantly updating with news from all over the world and the status of the mission.

At the front of the room looks to be Greg the Head Scientist and to the South is the Launch Pad.

>talk to scientist
That's not a verb I recognise.

* * *

>s
(first opening the Metal Partition)
It seems to be locked.

>s
(first opening the Metal Partition)
It seems to be locked.

I beg your pardon?

>s
(first opening the Metal Partition)
It seems to be locked.

>ss
That's not a verb I recognise.

I beg your pardon?

* * *

>s
(first opening the Metal Partition)
It seems to be locked.

>e
Mission Control
A gigantic room filled with rows of moniters, each one manned by an Engineer or Scientist. In the front of the room is a large sceen constantly updating with news from all over the world and the status of the Mission.

At the front of the room looks to be Greg the Head Scientist and to the South is the Launch Pad.

* * *

>e
Training Room
In the training room you see a giant spinning Centrifuge in the middle of the room. Mastering the Centrifuge is a required of an astronaut that might take a few times to do correctly.

The Bathroom is to the West, and the Suit Storage Room is to the South.

You can see a Metal Partition here.

>enter centrifuge
You get onto the Centrifuge.

>s
(first getting off the Centrifuge)

Space Suit Storage
A small room filled with Space Suits hung on the wall behind a metal cage.

There look to be two exits one to the North, and one to the East.

>e
Mission Control
A gigantic room filled with rows of moniters, each one manned by an Engineer or Scientist. In the front of the room is a large sceen constantly updating with news from all over the world and the status of the Mission.

At the front of the room looks to be Greg the Head Scientist and to the South is the Launch Pad.

>e
You can't go that way.

>ee
That's not a verb I recognise.

>e
You can't go that way.

* * *

I beg your pardon?

>w
Space Suit Storage
A small room filled with Space Suits hung on the wall behind a metal cage.

There look to be two exits one to the North, and one to the East.

I beg your pardon?

>w
You can't go that way.

I beg your pardon?

>s
You can't go that way.

>s
You can't go that way.

* * *

I beg your pardon?

>e
Mission Control
A gigantic room filled with rows of moniters, each one manned by an Engineer or Scientist. In the front of the room is a large sceen constantly updating with news from all over the world and the status of the Mission.

At the front of the room looks to be Greg the Head Scientist and to the South is the Launch Pad.

* * *

>e
You can't go that way.

>ww
That's not a verb I recognise.

I beg your pardon?

* * *

>w
Space Suit Storage
A small room filled with Space Suits hung on the wall behind a metal cage.

There look to be two exits one to the North, and one to the East.

>e
Mission Control
A gigantic room filled with rows of moniters, each one manned by an Engineer or Scientist. In the front of the room is a large sceen constantly updating with news from all over the world and the status of the Mission.

At the front of the room looks to be Greg the Head Scientist and to the South is the Launch Pad.

* * *

>e
You can't go that way.

>w
Space Suit Storage
A small room filled with Space Suits hung on the wall behind a metal cage.

There look to be two exits one to the North, and one to the East.

* * *

>e
You can't go that way.

>ew
That's not a verb I recognise.

I beg your pardon?

* * *

>e
Mission Control
A gigantic room filled with rows of moniters, each one manned by an Engineer or Scientist. In the front of the room is a large sceen constantly updating with news from all over the world and the status of the Mission.

At the front of the room looks to be Greg the Head Scientist and to the South is the Launch Pad.

I beg your pardon?

>s
Launch Pad
As you open the doors from mission control to go outside, you leave the airconditioned building behind. In the distance you see a giant Rocket of immense propotions. It's reflective surface glint beams of sunlight through the air.

Around the launch pad you spot a Refuelling Station that looks like it could be used to fill up the rocket. Connected to the rocket is a metal tower with a Elevator which looks like it could be used to get to the Loading zone. Running up the Side of the metal tower is a Fuel Tube.

The Elevator is to the East.

I beg your pardon?

* * *

>w
You can't go that way.

>e
Elevator
A large stainless steel elevator used to load cargo as well as transport people up to the Flight Deck. From a speaker in the elevator plays a relaxing soft jazz.

On the wall of the Elevator you see a Green Button pointing Up and a Red Button Pointing Down.

* * *

From the Moon with Love
An Interactive Fiction by Matthew Shimura
Release 1 / Serial number 130306 / Inform 7 build 6G60 (I6/v6.32 lib 6/12N) SD

Bathroom
A spotless tiled restroom with many stalls and a large spanning mirror along the wall. It seems very peaceful here, but you smell a stong odor in the air of cleaning chemicals. In the back of the room you see a utility closet that looks to be used by the Janitor.

The exit to the Bathroom is to the East.

You can see a wallet here.

>s
You can't go that way.

>e
Training Room
In the training room you see a giant spinning Centrifuge used to test the tolerance of Astronauts to acceleration for the conditions of space. Mastering the Centrifuge is a required of an astronaut that might take a few times to do correctly.

>s
Space Suit Storage
A cramped room with Space Suits hung on the wall Behind a metal grate.

There look to be two enterances one to the North, and one to the .

* * *

From the Moon with Love
An Interactive Fiction by Matthew Shimura
Release 1 / Serial number 130306 / Inform 7 build 6G60 (I6/v6.32 lib 6/12N) SD

Bathroom
A spotless tiled restroom with many stalls and a large spanning mirror along the wall. It seems very peaceful here, but you smell a stong odor in the air of cleaning chemicals. In the back of the room you see a utility closet that looks to be used by the Janitor.

The exit to the Bathroom is to the East.

You can see a wallet here.

>x janitor
The Janitor is on break and not here right now.

>e
Training Room
In the training room you see a giant spinning Centrifuge used to test the tolerance of Astronauts to acceleration for the conditions of space. Mastering the Centrifuge is a required of an astronaut that might take a few times to do correctly.

The Bathroom is to the West, and the Suit Storage Room is to the South

>s
Space Suit Storage
A small room filled with Space Suits hung on the wall behind a metal cage.

There look to be two exits one to the North, and one to the East.

>e
Mission Control
A gigantic room filled with rows of moniters, each one manned by an Engineer or Scientist. In the front of the room is a large sceen constantly updating with news from all over the world and the status of the Mission.

At the front of the room looks to be Greg the Head Scientist and to the South is the Launch Pad.