You wake up groggily from a hangover, and find yourself sitting on a toilet. All you can remember is that you are in the command center for a space program on Earth. Not remembering who you are, what your purpose is, or why you are here, confuses you greatly. You must find out…

From the Moon with Love
An Interactive Fiction by Matthew Shimura
Release 1 / Serial number 130312 / Inform 7 build 6G60 (I6/v6.32 lib 6/12N) SD

Bathroom
A spotless tiled restroom with many stalls and a large spanning mirror along the wall. It seems very peaceful here. In the back of the room you see a utility closet that looks to be used by the Janitor.

The exit to the Bathroom is to the East.

>x utility closet
A closets used for storing cleaning chemicals and a wrench to keep the bathroom in working order.

[Your score has just gone up by one point.]

* * *

>open cabinet
You can't see any such thing.

>open closet
You open the utility closet, revealing a chemicals and a wrench.

>take wrench
Taken.

* * *

>take chemicals
Taken.

>take chemical
You can't see any such thing.

>x wallet
A wallet with 3,047 rubles in it. The wallet belongs to a young astronaut named, Victor Sasha Reznov.

As you open the wallet, a crumpled paper falls to the floor.

[Your score has just gone up by one point.]

>x crumpled paper
On the crumpled paper you see "Mission Details: To go to the moon and plant…" You cannont read the rest."

* * *

>take wallet
Is this your wallet? Maybe you are an astronaut?

* * *

>fix
I didn't understand that sentence.

>fix valve
You need a tool to fix the valve

>open closet
You open the utility closet, revealing a chemicals and a wrench.

* * *

>open closet
You open the utility closet and reveal some chemicals and a wrench.

* * *

>take wrench
Taken.

>e
Training Room
In the training room you see a giant spinning Centrifuge in the middle of the room. Getting in the Centrifuge is a required of an astronaut to complete their training.

The bathroom is to the West, and the storage room is to the South.

You can see a partition here.

>get in centrifuge
You get into the centrifuge and it spins round and round until your stomache feels like it is going to bust open. You get very quezzy and feel like you almost want to barf.

 Finally, the spinning stops, and you get out of the centrifuge.  You hear the click of the Partition unlocking.

* * *

>e
Mission Control
A gigantic room filled with rows of moniters, each one manned by an Engineer or Scientist. In the front of the room is a large sceen constantly updating with news from all over the world and the status of the mission.

At the front of the room looks to be Greg the Head Scientist and to the South is the Launch Pad.

>s
Launch Pad
As you open the doors from mission control to go outside, you leave the airconditioned building behind. In the distance you see a giant Rocket of immense propotions. It's reflective surface glint beams of sunlight through the air.

Around the launch pad you spot a Refuelling Station that looks like it could be used to fill up the rocket. Connected to the rocket is a metal tower with a Elevator which looks like it could be used to get to the Loading zone. Running up the side of the metal tower is a Fuel Tube.

The Stairs are to the West.

* * *

>open closed
You can't see any such thing.

* * *

>e
Training Room
In the training room you see a giant spinning Centrifuge in the middle of the room. Getting in the Centrifuge is a required of an astronaut to complete their training.

The bathroom is to the West, and the storage room is to the South.

You can see a partition here.

>get in centrifuge
You get into the centrifuge and it spins round and round until your stomach feels like it is going to bust open. You get very queazy and feel like you almost want to barf.

 Finally, the spinning stops, and you get out of the centrifuge.  You hear the click of the Partition unlocking.

>s
(first opening the partition)

Storage Room
A small room filled with Space Suits and Space Helmets hung on the wall behind a Cage.

There look to be two exits one to the North, and one to the East.

You can see a partition and a Cage (closed) here.

>e
Mission Control
A gigantic room filled with rows of monitors, each one manned by an Engineer or Scientist. In the front of the room is a large screen constantly updating with news from all over the world and the status of the mission. In the corner you spot a Trash Can.

At the front of the room looks to be Greg the Head Scientist, to the west is the Storage room, and to the South is the Launch Pad.

>talk to greg
"Hi there, I'm Greg the Head Scientist. You must be the new astronaut. I'm very busy right now, but I must tell you what you need to do for your mission to the moon. First you must aquire you space suit."  Greg opens his hand, and in it is the master key.

* * *

>e
Mission Control
A gigantic room filled with rows of monitors, each one manned by an Engineer or Scientist. In the front of the room is a large screen constantly updating with news from all over the world and the status of the mission. In the corner you spot a Trash Can.

At the front of the room looks to be Greg the Head Scientist, to the west is the Storage room, and to the South is the Launch Pad.

>s
Launch Pad
As you open the doors from mission control to go outside, you leave the airconditioned building behind. In the distance you see a giant Rocket of immense propotions. It's reflective surface glint beams of sunlight through the air.

Around the launch pad you spot a Refuelling Station that looks like it could be used to fill up the rocket. Connected to the rocket is a metal tower with a Elevator which looks like it could be used to get to the Loading zone. Running up the side of the metal tower is a Fuel Tube.

The Stairs are to the West.

* * *

>w
Stairs
Large wrought iron stairs that look to be the only way Up to the loading zone. It looks like it will be good exercise.

>up
Loading Zone
 A platform at the top of the metal tower. This platform is hundreds of feet in the air, and below you can seen the space base. From up here everything looks so small and the people below look like ants.

Across a large gap you see the rocket, but you cannont get to it yet.

Up here at the Loading Zone you can see a Control Pane which looks like it controls all the rocket's fuel tubes as well as the launch mecanism.

To get back to the Launch Pad use the stairs to go back down. 

You can see an Air Lock here.

>d
Stairs
Large wrought iron stairs that look to be the only way Up to the loading zone. It looks like it will be good exercise.

>u
Loading Zone
 A platform at the top of the metal tower. This platform is hundreds of feet in the air, and below you can seen the space base. From up here everything looks so small and the people below look like ants.

Across a large gap you see the rocket, but you cannont get to it yet.

Up here at the Loading Zone you can see a Control Pane which looks like it controls all the rocket's fuel tubes as well as the launch mecanism.

To get back to the Launch Pad use the stairs to go back down. 

You can see an Air Lock here.

>pull docking lever
You can't launch the rocket without the launch command!

* * *

>s
Launch Pad
As you open the doors from mission control to go outside, you leave the airconditioned building behind. In the distance you see a giant Rocket of immense propotions. It's reflective surface glint beams of sunlight through the air.

Around the launch pad you spot a Refuelling Station that looks like it could be used to fill up the rocket. Connected to the rocket is a metal tower with a Elevator which looks like it could be used to get to the Loading zone. Running up the side of the metal tower is a Fuel Tube.

The Stairs are to the West.

>n
Mission Control
A gigantic room filled with rows of moniters, each one manned by an Engineer or Scientist. In the front of the room is a large sceen constantly updating with news from all over the world and the status of the mission.

At the front of the room looks to be Greg the Head Scientist and to the South is the Launch Pad.

>get the launch command
Now go to the loading zone and pull the launching lever.

>e
You can't go that way.

>w
Storage Room
A small room filled with Space Suits and Space Helmets hung on the wall behind a Cage.

There look to be two exits one to the North, and one to the East.

You can see a partition and a Cage (closed) here.

>n
Training Room
In the training room you see a giant spinning Centrifuge in the middle of the room.

Getting in the Centrifuge is a required of an astronaut, and might take a few times to do correctly.

The bathroom is to the West, and the storage room is to the South.

You can see a partition here.

>up
You can't go that way.

>e
You can't go that way.

>s
Storage Room
A small room filled with Space Suits and Space Helmets hung on the wall behind a Cage.

There look to be two exits one to the North, and one to the East.

You can see a partition and a Cage (closed) here.

>e
Mission Control
A gigantic room filled with rows of moniters, each one manned by an Engineer or Scientist. In the front of the room is a large sceen constantly updating with news from all over the world and the status of the mission.

At the front of the room looks to be Greg the Head Scientist and to the South is the Launch Pad.

* * *

>s
Launch Pad
As you open the doors from mission control to go outside, you leave the airconditioned building behind. In the distance you see a giant Rocket of immense propotions. It's reflective surface glint beams of sunlight through the air.

Around the launch pad you spot a Refuelling Station that looks like it could be used to fill up the rocket. Connected to the rocket is a metal tower with a Elevator which looks like it could be used to get to the Loading zone. Running up the side of the metal tower is a Fuel Tube.

The Stairs are to the West.

>s
You can't go that way.

>w
Stairs
Large wrought iron stairs that look to be the only way Up to the loading zone. It looks like it will be good exercise.

>u
Loading Zone
 A platform at the top of the metal tower. This platform is hundreds of feet in the air, and below you can seen the space base. From up here everything looks so small and the people below look like ants.

Across a large gap you see the rocket, but you cannont get to it yet.

Up here at the Loading Zone you can see a Control Pane which looks like it controls all the rocket's fuel tubes as well as the launch mecanism.

To get back to the Launch Pad use the stairs to go back down. 

You can see an Air Lock here.

>pull docking lever
You can't see any such thing.

>pull launching lever
Now that the rocket is fueled and you are ready to go you are ready to launch. You put your space suit on and walk slowly to the rocket. The Airlock unlocks with a hiss of hydraulics and you step inside. You go up to the flight deck, and strap into your seat and get ready to launch.

  5.  4.  3.  2.  1.  We have liftoff…

 You suddenly feel the thrusters engage and the rocket starts to blast off with an ear shattering roar. The rocket starts to move faster and faster, and it feels like the skin on your face is being pulled back because of the force. As the ship rattles you hear a voice over the loudspeaker. "Detaching Rockets"
 The shuttle detaches from the rocket, and you have finally reached space.
 
Flight Deck
At the head of the Space Shuttle is the flight deck where the entirety of the ship is controlled. You see three seats, one for the captain, one for the engineer, and one for you.

In front of the seats is a thick Windsceen the protects you from outer space and allows you to see out the front so you can see out of the ship, and the Controls to the space shuttles.

>d
Crew Compartment
You step inside the Space Shuttle to the Crew Compartment the place where spend most of your time living and working on your voyage. You can see your way through the metal room with the fluroscent lights illuminating your way. You now stand on one of the walls of the space shuttle, as there is no gravity.

In the Crew Compartment you spot some Beds, a Work Bench, and some storage Cabinets. Below you in the Space Shuttle is the Lower Deck, and Above you is the Flight Deck.

>open cabinet
In the cabinet, you see a red flag, vodka, and a shovel.

>take red flag
You can't see any such thing.

>take flag
As you look at the flag you realize you are not an American Astronaut, but a Russian one. You suddenly remember the details of your mission. Go to the moon, claim it for the Motherland, and destroy all traces of the Americans..

* * *

>e
Mission Control
A gigantic room filled with rows of monitors, each one manned by an Engineer or Scientist. In the front of the room is a large screen constantly updating with news from all over the world and the status of the mission. In the corner you spot a Trash Can.

At the front of the room looks to be Greg the Head Scientist, to the west is the Storage room, and to the South is the Launch Pad.

>take launch command
"Now go to the loading zone and Launch the Rocket."

>s
Launch Pad
As you open the doors from mission control to go outside, you leave the air conditioned building behind. In the distance you see a giant Rocket of immense proportions. It's reflective surface glint beams of sunlight through the air.

Around the launch pad you spot a Refueling Station that looks like it could be used to fuel up the rocket. Running up the side of the metal tower is a Fuel Tube.

The Stairs going up the tower are to the West and Mission Control is to the North.

>w
Stairs
Large wrought iron stairs that look to be the only way Up to the loading zone. It looks like it will be good exercise.

* * *

>up
Loading Zone
 A platform at the top of the metal tower. This platform is hundreds of feet in the air, and below you can seen the space base. From up here everything looks so small and the people below look like ants.

Across a large gap you see the rocket, but you cannont get to it yet.

Up here at the Loading Zone you can see a Control Pane which looks like it controls all the rocket's fuel tubes as well as the launch mecanism.

To get back to the Launch Pad use the stairs to go back down. 

You can see an Air Lock here.

>pull docking lever
Now that the rocket is fueled and you are ready to go you are ready to launch. You put your space suit on and walk slowly to the rocket. The Airlock unlocks with a hiss of hydraulics and you step inside. You go up to the flight deck, and strap into your seat and get ready to launch.

  5.  4.  3.  2.  1.  We have liftoff…

 You suddenly feel the thrusters engage and the rocket starts to blast off with an ear shattering roar. The rocket starts to move faster and faster, and it feels like the skin on your face is being pulled back because of the force. As the ship rattles you hear a voice over the loudspeaker. "Detaching Rockets"
 The shuttle detaches from the rocket, and you have finally reached space.
 
Flight Deck
At the head of the Space Shuttle is the flight deck where the entirety of the ship is controlled. You see three seats, one for the captain, one for the engineer, and one for you.

In front of the seats is a thick Windsceen the protects you from outer space and allows you to see out the front so you can see out of the ship, and the Controls to the space shuttles.

>s
You can't go that way.

>d
Crew Compartment
You step inside the Space Shuttle to the Crew Compartment the place where spend most of your time living and working on your voyage. You can see your way through the metal room with the fluroscent lights illuminating your way. You now stand on one of the walls of the space shuttle, as there is no gravity.

In the Crew Compartment you spot some Beds, a Work Bench, and some storage Cabinets. Below you in the Space Shuttle is the Lower Deck, and Above you is the Flight Deck.

>open cabinets
In the cabinet, you see a flag, vodka, and a shovel.

>take shovel
Taken.

>w
Airlock
A room that seperates space from the inner space ship.

With a hiss of hydraulics and pressure one side of the Airlock closes and the other opens.

>w
OuterSpace
You float in space after leaving the shuttle and stare at the emptiness of space. You cannont hear anything except the crackle of your headset telling you to complete you mission by landing on the moon Below.

You remember a quote you once heard from a movie. "In space, no one can hear you scream. "

>d
Moon Surface
A large expanse of land in space with giagantic craters strewn across the surface. You see the footprints of previous moon expeditions and across the way you see the American flag.

You also see a hole that looks partially filled up. If you had a shovel you might dig it up.

>open hole
You can't see any such thing.

* * *

>w
Stairs
Large wrought iron stairs that look to be the only way Up to the loading zone. It looks like it will be good exercise.

>u
Loading Zone
 A platform at the top of the metal tower. This platform is hundreds of feet in the air, and below you can seen the space base. From up here everything looks so small and the people below look like ants.

Across a large gap you see the rocket, but you cannot get to it yet.

Up here at the Loading Zone you can see a Control Pane which looks like it controls all the rocket's fuel tubes as well as the Launch Mechanism.

To get back to the Launch Pad use the stairs to go back down. 

You can see an Air Lock here.

>pull launching lever
Now that the rocket is fueled and you are ready to go you are ready to launch. You put your space suit on and walk slowly to the rocket. The Airlock unlocks with a hiss of hydraulics and you step inside. You go up to the flight deck, and strap into your seat and get ready to launch.

  5.  4.  3.  2.  1.  We have liftoff…

 You suddenly feel the thrusters engage and the rocket starts to blast off with an ear shattering roar. The rocket starts to move faster and faster, and it feels like the skin on your face is being pulled back because of the force. As the ship rattles you hear a voice over the loudspeaker. "Detaching Rockets"
 The shuttle detaches from the rocket, and you have finally reached space.
 
Flight Deck
At the head of the Space Shuttle is the flight deck where the entirety of the ship is controlled. You see three seats, one for the captain, one for the engineer, and one for you although you are the only one on the mission.

In front of the seats is a thick Windscreen the protects you from outer space and allows you to see out the front so you can pilot the ship and use the Controls to the space shuttle.

>i
You are carrying:
  a Space Helmet (being worn)
  a Space Suit (being worn)
  a launch command

>x launch command
The code used at the Control Pane to launch the Rocket.

[Your score has just gone up by one point.]

>d
Crew Compartment
You step inside the Space Shuttle to the Crew Compartment the place where spend most of your time living and working on your voyage. You can see your way through the metal room with the fluorescent lights illuminating your way. You now stand on one of the walls of the space shuttle, as there is no gravity.

In the Crew Compartment you spot some Beds, a Work Bench, and some storage Cabinets. Below you in the Space Shuttle is the Lower Deck, and Above you is the Flight Deck.

>w
Airlock
A room that separates space from the inner space ship.

With a hiss of hydraulics and pressure one side of the Airlock closes and the other opens.

>w
OuterSpace
You float in space after leaving the shuttle and stare at the emptiness of space. You cannot hear anything except the crackle of your headset telling you to complete you mission by landing on the moon Below.

You remember a quote you once heard from a movie. "In space, no one can hear you scream. "

>e
Airlock
A room that separates space from the inner space ship.

With a hiss of hydraulics and pressure one side of the Airlock closes and the other opens.

>e
Crew Compartment
You step inside the Space Shuttle to the Crew Compartment the place where spend most of your time living and working on your voyage. You can see your way through the metal room with the fluorescent lights illuminating your way. You now stand on one of the walls of the space shuttle, as there is no gravity.

In the Crew Compartment you spot some Beds, a Work Bench, and some storage Cabinets. Below you in the Space Shuttle is the Lower Deck, and Above you is the Flight Deck.

>open cabinet
In the cabinet, you see a flag, vodka, and a shovel.

>take flag
As you look at the flag you realize you are not an American Astronaut, but a Russian one. You suddenly remember some of  the details of your mission. Go to the moon, claim it for the Motherland, and destroy all traces of the Americans.

>take shovel
Taken.

>w
Airlock
A room that separates space from the inner space ship.

With a hiss of hydraulics and pressure one side of the Airlock closes and the other opens.

* * *

>w
OuterSpace
You float in space after leaving the shuttle and stare at the emptiness of space. You cannot hear anything except the crackle of your headset telling you to complete you mission by landing on the moon Below.

You remember a quote you once heard from a movie. "In space, no one can hear you scream. "

>d
Moon Surface
A large expanse of land in space with gigantic craters strewn across the surface. You see the footprints of previous moon expeditions and across the way you see the American flag.

You also see a Hole in the ground that you might be able to open.

>open hole
You dig a hole in the moon with your shovel, which looks like the russian Flag can go in it.

>x hole
Hole is empty.

>undo
Moon Surface
[Previous turn undone.]

>undo
Moon Surface
[Previous turn undone.]

>undo
OuterSpace
[Previous turn undone.]

>d
Moon Surface
A large expanse of land in space with gigantic craters strewn across the surface. You see the footprints of previous moon expeditions and across the way you see the American flag.

You also see a Hole in the ground that you might be able to open.

>x hole
You see nothing special about Hole.

>open hole
You dig a hole in the moon with your shovel, which looks like the russian Flag can go in it.

>put flag into hole
(the Flag into Hole)
You put the Flag into Hole.

>undo
Moon Surface
[Previous turn undone.]

>put flag in hole
(the Flag in Hole)

 You put the flag of the motherland in the hole and claim the Moon FOR RUSSIA!!! 

 Now that your mission is complete you radio back to mission control. "Thank you for your service to the Country. Your sacrifice will be remembered," says mission control over the radio.

 Remembered? I'm not dead yet.

 Suddenly, you have a hard time breathing, your oxygen supply seems to be depleting. BOOM! the space shuttle explodes behind you.

 In your last moments, you finally remember the mission details. 

 To go to the moon and plant Russia's flag. After completing your mission, your life will then be terminated as your use has ended… 
 

    *** You have won ***

In that game you scored 1 out of a possible 53, in 25 turns.

Would you like to RESTART, RESTORE a saved game, QUIT or UNDO the last command?

* * *

>take launch command
"Now go to the loading zone and Launch the Rocket."

>e
You can't go that way.

* * *

>w
Storage Room
A small room filled with Space Suits and Space Helmets hung on the wall behind a Cage.

There look to be two exits one to the North, and one to the East.

You can see a partition and a Cage (closed) here.

>s
You can't go that way.

>w
You can't go that way.

>e
Mission Control
A gigantic room filled with rows of moniters, each one manned by an Engineer or Scientist. In the front of the room is a large sceen constantly updating with news from all over the world and the status of the mission.

At the front of the room looks to be Greg the Head Scientist and to the South is the Launch Pad.

* * *

>u
Loading Zone
 A platform at the top of the metal tower. This platform is hundreds of feet in the air, and below you can seen the space base. From up here everything looks so small and the people below look like ants.

Across a large gap you see the rocket, but you cannont get to it yet.

Up here at the Loading Zone you can see a Control Pane which looks like it controls all the rocket's fuel tubes as well as the launch mecanism.

To get back to the Launch Pad use the stairs to go back down. 

You can see an Air Lock here.

>pull docking lever
Now that the rocket is fueled and you are ready to go you are ready to launch. You put your space suit on and walk slowly to the rocket. The Airlock unlocks with a hiss of hydraulics and you step inside. You go up to the flight deck, and strap into your seat and get ready to launch.

  5.  4.  3.  2.  1.  We have liftoff…

 You suddenly feel the thrusters engage and the rocket starts to blast off with an ear shattering roar. The rocket starts to move faster and faster, and it feels like the skin on your face is being pulled back because of the force. As the ship rattles you hear a voice over the loudspeaker. "Detaching Rockets"
 The shuttle detaches from the rocket, and you have finally reached space.
 
Flight Deck
At the head of the Space Shuttle is the flight deck where the entirety of the ship is controlled. You see three seats, one for the captain, one for the engineer, and one for you.

In front of the seats is a thick Windsceen the protects you from outer space and allows you to see out the front so you can see out of the ship, and the Controls to the space shuttles.

* * *

>d
Crew Compartment
You step inside the Space Shuttle to the Crew Compartment the place where spend most of your time living and working on your voyage. You can see your way through the metal room with the fluroscent lights illuminating your way. You now stand on one of the walls of the space shuttle, as there is no gravity.

In the Crew Compartment you spot some Beds, a Work Bench, and some storage Cabinets. Below you in the Space Shuttle is the Lower Deck, and Above you is the Flight Deck.

>open cabinet
In the cabinet, you see a flag, vodka, and a shovel.

* * *

>take shovel
Taken.

I beg your pardon?

>e
You can't go that way.

>w
Airlock
A room that seperates space from the inner space ship.

With a hiss of hydraulics and pressure one side of the Airlock closes and the other opens.

* * *

>w
OuterSpace
You float in space after leaving the shuttle and stare at the emptiness of space. You cannont hear anything except the crackle of your headset telling you to complete you mission by landing on the moon Below.

You remember a quote you once heard from a movie. "In space, no one can hear you scream. "

>s
You can't go that way.

>d
Moon Surface
A large expanse of land in space with giagantic craters strewn across the surface. You see the footprints of previous moon expeditions and across the way you see the American flag.

You also see a Hole in the ground that you might be able to open.

>dig up the hole
That's not a verb I recognise.

>dig the hole
That's not a verb I recognise.

>dig hole
That's not a verb I recognise.

>open hole
You dig a hole in the moon, which looks like your Flag can go in it

>up
OuterSpace
You float in space after leaving the shuttle and stare at the emptiness of space. You cannont hear anything except the crackle of your headset telling you to complete you mission by landing on the moon Below.

You remember a quote you once heard from a movie. "In space, no one can hear you scream. "

>e
Airlock
A room that seperates space from the inner space ship.

With a hiss of hydraulics and pressure one side of the Airlock closes and the other opens.

>e
Crew Compartment
You step inside the Space Shuttle to the Crew Compartment the place where spend most of your time living and working on your voyage. You can see your way through the metal room with the fluroscent lights illuminating your way. You now stand on one of the walls of the space shuttle, as there is no gravity.

In the Crew Compartment you spot some Beds, a Work Bench, and some storage Cabinets. Below you in the Space Shuttle is the Lower Deck, and Above you is the Flight Deck.

>take flag
You can't see any such thing.

>open cabinets
That's already open.

>close cabinet
You close the Cabinets.

>open cabinet
In the cabinet, you see a flag, vodka, and a shovel.

>take flag
You can't see any such thing.

>x flag
You can't see any such thing.

* * *

>e
Training Room
In the training room you see a giant spinning Centrifuge in the middle of the room. Getting in the Centrifuge is a required of an astronaut to complete their training.

The bathroom is to the West, and the storage room is to the South.

You can see a partition here.

>s
(first opening the partition)
It seems to be locked.

>get in centrifuge
You get into the centrifuge and it spins round and round until your stomache feels like it is going to bust open. You get very quezzy and feel like you almost want to barf.

 Finally, the spinning stops, and you get out of the centrifuge.  You hear the click of the Partition unlocking.

* * *

>e
Mission Control
A gigantic room filled with rows of moniters, each one manned by an Engineer or Scientist. In the front of the room is a large sceen constantly updating with news from all over the world and the status of the mission.

At the front of the room looks to be Greg the Head Scientist and to the South is the Launch Pad.

>talk to greg
"Hi there, I'm Greg the Head Scientist. You must be the new astronaut. I'm very busy right now, but I must tell you what you need to do for your mission to the moon. First you must aquire you space suit."  Greg opens his hand, and in it is the master key.

>talk to greg
Come back to me when you have your space suit AND have refueled the rocket

>take the launch command
Now go to the loading zone and pull the launching lever.

>s
Launch Pad
As you open the doors from mission control to go outside, you leave the airconditioned building behind. In the distance you see a giant Rocket of immense propotions. It's reflective surface glint beams of sunlight through the air.

Around the launch pad you spot a Refuelling Station that looks like it could be used to fill up the rocket. Connected to the rocket is a metal tower with a Elevator which looks like it could be used to get to the Loading zone. Running up the side of the metal tower is a Fuel Tube.

The Stairs are to the West.

* * *

>u
Loading Zone
 A platform at the top of the metal tower. This platform is hundreds of feet in the air, and below you can seen the space base. From up here everything looks so small and the people below look like ants.

Across a large gap you see the rocket, but you cannont get to it yet.

Up here at the Loading Zone you can see a Control Pane which looks like it controls all the rocket's fuel tubes as well as the launch mecanism.

To get back to the Launch Pad use the stairs to go back down. 

You can see an Air Lock here.

>pull launching lever
Now that the rocket is fueled and you are ready to go you are ready to launch. You put your space suit on and walk slowly to the rocket. The Airlock unlocks with a hiss of hydraulics and you step inside. You go up to the flight deck, and strap into your seat and get ready to launch.

  5.  4.  3.  2.  1.  We have liftoff…

 You suddenly feel the thrusters engage and the rocket starts to blast off with an ear shattering roar. The rocket starts to move faster and faster, and it feels like the skin on your face is being pulled back because of the force. As the ship rattles you hear a voice over the loudspeaker. "Detaching Rockets"
 The shuttle detaches from the rocket, and you have finally reached space.
 
Flight Deck
At the head of the Space Shuttle is the flight deck where the entirety of the ship is controlled. You see three seats, one for the captain, one for the engineer, and one for you.

In front of the seats is a thick Windsceen the protects you from outer space and allows you to see out the front so you can see out of the ship, and the Controls to the space shuttles.

* * *

>d
Crew Compartment
You step inside the Space Shuttle to the Crew Compartment the place where spend most of your time living and working on your voyage. You can see your way through the metal room with the fluroscent lights illuminating your way. You now stand on one of the walls of the space shuttle, as there is no gravity.

In the Crew Compartment you spot some Beds, a Work Bench, and some storage Cabinets. Below you in the Space Shuttle is the Lower Deck, and Above you is the Flight Deck.

>u
Flight Deck
At the head of the Space Shuttle is the flight deck where the entirety of the ship is controlled. You see three seats, one for the captain, one for the engineer, and one for you.

In front of the seats is a thick Windsceen the protects you from outer space and allows you to see out the front so you can see out of the ship, and the Controls to the space shuttles.

>x controls
The controls for landing on the moon and manipulating the space shuttle

>x
(the launch command)
The code used at the Control Pane to launch the Rocket.

>d
Crew Compartment
You step inside the Space Shuttle to the Crew Compartment the place where spend most of your time living and working on your voyage. You can see your way through the metal room with the fluroscent lights illuminating your way. You now stand on one of the walls of the space shuttle, as there is no gravity.

In the Crew Compartment you spot some Beds, a Work Bench, and some storage Cabinets. Below you in the Space Shuttle is the Lower Deck, and Above you is the Flight Deck.

* * *

>open cabinets
In the cabinet, you see a flag, vodka, and a shovel.

>x cabinets
A thick metal cabinet that solidly rings when you tap on it. It looks like it could hold some things needed for you mission on the Moon.

In the Cabinets is a Vodka.

>take flag
As you look at the flag you realize you are not an American Astronaut, but a Russian one. You suddenly remember some of  the details of your mission. Go to the moon, claim it for the Motherland, and destroy all traces of the Americans.

>take the vodka
Taken.

>take vodka
You already have that.

>take shovel
Taken.

>drink vodka
Your head feels woozy as you take a swig from the bottle. The high alcohol content might be useful for something later on you say to yourself, and save the rest of the bottle.

>w
Airlock
A room that seperates space from the inner space ship.

With a hiss of hydraulics and pressure one side of the Airlock closes and the other opens.

* * *

>w
OuterSpace
You float in space after leaving the shuttle and stare at the emptiness of space. You cannont hear anything except the crackle of your headset telling you to complete you mission by landing on the moon Below.

You remember a quote you once heard from a movie. "In space, no one can hear you scream. "

>w
You can't go that way.

>d
Moon Surface
A large expanse of land in space with giagantic craters strewn across the surface. You see the footprints of previous moon expeditions and across the way you see the American flag.

You also see a Hole in the ground that you might be able to open.

>dig hole
That's not a verb I recognise.

>open the hole
You dig a hole in the moon with your shovel, which looks like the russian Flag can go in it.

>put flag in hole
(the Flag in Hole)

 You put the flag of the motherland in the hole and claim the Moon FOR RUSSIA!!! 

 Now that your mission is complete you radio back to mission control. "Thank you for your service to the Country. Your sacrafise will be remembered." says mission control over the radio.

 Remembered? I'm not dead yet.

 Suddenly, you have a hard time breating, your oxygen supply seems to be depleating. BOOM! the space shuttle explodes behind you.

 In your last moments, you finally remember the mission details. 
 To go to the moon and plant russia's flag. After completing  your mission, your life will then be terminated as your use has ended… 潩戠捡⁫潴洠獩楳

 

    *** You have won ***

In that game you scored 0 out of a possible 0, in 30 turns.

Would you like to RESTART, RESTORE a saved game, QUIT or UNDO the last command?

* * *

>w
Stairs
Large wrought iron stairs that look to be the only way Up to the loading zone. It looks like it will be good exercise.

>e
Launch Pad
As you open the doors from mission control to go outside, you leave the airconditioned building behind. In the distance you see a giant Rocket of immense propotions. It's reflective surface glint beams of sunlight through the air.

Around the launch pad you spot a Refuelling Station that looks like it could be used to fill up the rocket. Connected to the rocket is a metal tower with a Elevator which looks like it could be used to get to the Loading zone. Running up the side of the metal tower is a Fuel Tube.

The Stairs are to the West.

>fix valve
That's not a verb I recognise.

* * *

>e
Training Room
In the training room you see a giant spinning Centrifuge in the middle of the room. Getting in the Centrifuge is a required of an astronaut to complete their training.

The bathroom is to the West, and the storage room is to the South.

You can see a partition here.

>w
Bathroom
A spotless tiled restroom with many stalls and a large spanning mirror along the wall. It seems very peaceful here. In the back of the room you see a utility closet that looks to be used by the Janitor.

The exit to the Bathroom is to the East.

>open closet
You open the utility closet and reveal some chemicals and a wrench.

* * *

>s
(first opening the partition)

Storage Room
A small room filled with Space Suits and Space Helmets hung on the wall behind a Cage.

There look to be two exits one to the North, and one to the East.

You can see a partition and a Cage (closed) here.

>e
Mission Control
A gigantic room filled with rows of moniters, each one manned by an Engineer or Scientist. In the front of the room is a large sceen constantly updating with news from all over the world and the status of the mission. In the corner you spot a Trash Can.

At the front of the room looks to be Greg the Head Scientist and to the South is the Launch Pad.

>talk to greg
"Hi there, I'm Greg the Head Scientist. You must be the new astronaut. I'm very busy right now, but I must tell you what you need to do for your mission to the moon. First you must aquire you space suit." Greg opens his hand, and in it is the  master key.

>take master key
Now that you have the key you can go get your Space Suit and helmet. Come back to me when you have done that.

>n
You can't go that way.

>e
You can't go that way.

* * *

>w
Storage Room
A small room filled with Space Suits and Space Helmets hung on the wall behind a Cage.

There look to be two exits one to the North, and one to the East.

You can see a partition and a Cage (closed) here.

>open cage with key
You unlock the Cage.

>x cage
A chainlink cage which inside of you see space suits and a space helmet.

[Your score has just gone up by one point.]

>take space helmet
You can't see any such thing.

>take space suit
You can't see any such thing.

>open cage
You open the Cage, revealing a Space Suit and a Space Helmet.

* * *

>take space helmet
Taken.

>x space suit
A garment worn to keep a human alive in the harsh enviroment of space from vacuum and extreme temperatures. When wearing the suit there is limited mobility.

[Your score has just gone up by one point.]

>x space helmet
A Helmet that lets you see out in space while still being able to breathe oxygen. The helmet also has a headset in it which allows you to hear what mission control has to tell you.

[Your score has just gone up by one point.]

>wear space suit
[Your score has just gone up by one point.]

>wear space helmet
[Your score has just gone up by one point.]

>e
Mission Control
A gigantic room filled with rows of moniters, each one manned by an Engineer or Scientist. In the front of the room is a large sceen constantly updating with news from all over the world and the status of the mission.

At the front of the room looks to be Greg the Head Scientist and to the South is the Launch Pad.

>talk to greg
Now that you have your space suit and helmet you should go fix the refueling station outside in the Launch Pad.

>take off space suit
You take off the Space Suit.

>talk to greg
Now that you have your space suit and helmet you should go fix the refueling station outside in the Launch Pad.

>undo
Mission Control
[Previous turn undone.]

>undo
Mission Control
[Previous turn undone.]

>undo
Storage Room
[Previous turn undone.]

>i
You are carrying:
  a Space Helmet (being worn)
  a Space Suit (being worn)
  a Master Key
  a wrench

>undo
Storage Room
[Previous turn undone.]

>undo
Storage Room
[Previous turn undone.]

>undo
"Undo" failed.  [Not all interpreters provide it.]

>i
You are carrying:
  a Space Helmet
  a Space Suit (being worn)
  a Master Key
  a wrench

>undo
Storage Room
[Previous turn undone.]

>i
You are carrying:
  a Space Helmet
  a Space Suit (being worn)
  a Master Key
  a wrench

>undol
That's not a verb I recognise.

>undo
Storage Room
[Previous turn undone.]

* * *

>i
You are carrying:
  a Space Helmet
  a Space Suit (being worn)
  a Master Key
  a wrench

>take off space wuit
Which do you mean, the Space Helmet or the Space Suit?

>space suit
You can't see any such thing.

>take off space suit
You take off the Space Suit.

>e
Mission Control
A gigantic room filled with rows of moniters, each one manned by an Engineer or Scientist. In the front of the room is a large sceen constantly updating with news from all over the world and the status of the mission.

At the front of the room looks to be Greg the Head Scientist and to the South is the Launch Pad.

* * *

>talk to greg
"Hi there, I'm Greg the Head Scientist. You must be the new astronaut. I'm very busy right now, but I must tell you what you need to do for your mission to the moon. First you must aquire you space suit." Greg opens his hand, and in it is the  master key.

>take the master key
Now that you have the key you can go get your Space Suit and helmet. Come back to me when you have done that.

>w
Storage Room
A small room filled with Space Suits and Space Helmets hung on the wall behind a Cage.

There look to be two exits one to the North, and one to the East.

You can see a partition and a Cage (closed) here.

>open cage
It seems to be locked.

>unlock the cage with key
You unlock the Cage.

>open cage
You open the Cage, revealing a Space Suit and a Space Helmet.

* * *

>take space helmet
Taken.

>wear space suit and space helmet
You can't use multiple objects with that verb.

>wear space suit
[Your score has just gone up by one point.]

* * *

>wear space helmet
[Your score has just gone up by one point.]

>e
Mission Control
A gigantic room filled with rows of moniters, each one manned by an Engineer or Scientist. In the front of the room is a large sceen constantly updating with news from all over the world and the status of the mission. In the corner you spot a Trash Can.

At the front of the room looks to be Greg the Head Scientist and to the South is the Launch Pad.

>talk to greg
Now that you have your space suit and helmet you should go fix the refueling station outside in the Launch Pad.

>s
Launch Pad
As you open the doors from mission control to go outside, you leave the airconditioned building behind. In the distance you see a giant Rocket of immense propotions. It's reflective surface glint beams of sunlight through the air.

Around the launch pad you spot a Refuelling Station that looks like it could be used to fuel up the rocket. Running up the side of the metal tower is a Fuel Tube.

The Stairs are to the West.

>x refueling station
You can't see any such thing.

>x refuelling station
A crucial part of the launch pad where carbon rich rocket fuel flows from the refueling station to the Rocket. Right now it does not seem to be working, as the Valve looks to be broken.

>fix the valve
You fix the valve with your wrench. You feel a rumble under the ground and suddenly the rocket fuel starts to flow from the refueling station, to the fuel tube, and to the rocket.
 You seem to have refueled the rocket and should now return to Greg.

>n
Mission Control
A gigantic room filled with rows of moniters, each one manned by an Engineer or Scientist. In the front of the room is a large sceen constantly updating with news from all over the world and the status of the mission. In the corner you spot a Trash Can.

At the front of the room looks to be Greg the Head Scientist and to the South is the Launch Pad.

>talk to greg
Now that you have your space suit and helmet you should go fix the refueling station outside in the Launch Pad.

>i
You are carrying:
  a token
  a Space Helmet (being worn)
  a Space Suit (being worn)
  a Master Key
  a wrench

* * *

>s
(first opening the partition)

Storage Room
A small room filled with Space Suits and Space Helmets hung on the wall behind a Cage.

There look to be two exits one to the North, and one to the East.

You can see a partition and a Cage (closed) here.

>e
Mission Control
A gigantic room filled with rows of moniters, each one manned by an Engineer or Scientist. In the front of the room is a large sceen constantly updating with news from all over the world and the status of the mission. In the corner you spot a Trash Can.

At the front of the room looks to be Greg the Head Scientist, to the west is the Storage room, and to the South is the Launch Pad.

>talk to greg
"Hi there, I'm Greg the Head Scientist. You must be the new astronaut. I'm very busy right now, but I must tell you what you need to do for your mission to the moon. First you must aquire you space suit." Greg opens his hand, and in it is the  master key.

>take key
Now that you have the key you can go get your Space Suit and helmet. Come back to me when you have done that.

>w
Storage Room
A small room filled with Space Suits and Space Helmets hung on the wall behind a Cage.

There look to be two exits one to the North, and one to the East.

You can see a partition and a Cage (closed) here.

* * *

>take helmet
Taken.

>e
Mission Control
A gigantic room filled with rows of moniters, each one manned by an Engineer or Scientist. In the front of the room is a large sceen constantly updating with news from all over the world and the status of the mission. In the corner you spot a Trash Can.

At the front of the room looks to be Greg the Head Scientist, to the west is the Storage room, and to the South is the Launch Pad.

>talk to greg
"Now that you have your space suit and helmet you should go fix the refueling station outside in the Launch Pad," says Greg.

 Come back to me when you have completed the missions I gave you.

>s
Launch Pad
As you open the doors from mission control to go outside, you leave the airconditioned building behind. In the distance you see a giant Rocket of immense propotions. It's reflective surface glint beams of sunlight through the air.

Around the launch pad you spot a Refuelling Station that looks like it could be used to fuel up the rocket. Running up the side of the metal tower is a Fuel Tube.

The Stairs going up the tower are to the West and Mission Control is to the North.

>fix the valve
You fix the valve with your wrench. You feel a rumble under the ground and suddenly the rocket fuel starts to flow from the refueling station, to the fuel tube, and to the rocket.
 You seem to have refueled the rocket and should now return to Greg.

>i
You are carrying:
  a token
  a Space Helmet
  a Space Suit
  a Master Key
  a wrench

>n
Mission Control
A gigantic room filled with rows of moniters, each one manned by an Engineer or Scientist. In the front of the room is a large sceen constantly updating with news from all over the world and the status of the mission. In the corner you spot a Trash Can.

At the front of the room looks to be Greg the Head Scientist, to the west is the Storage room, and to the South is the Launch Pad.

>talk to greg
"Now that you have your space suit and helmet you should go fix the refueling station outside in the Launch Pad," says Greg.
"You are now ready to go to the rocket. Here is the launch command." Greg hands you the launch command.

>take launch command
"Now go to the loading zone and Launch the Rocket."

>s
Launch Pad
As you open the doors from mission control to go outside, you leave the airconditioned building behind. In the distance you see a giant Rocket of immense propotions. It's reflective surface glint beams of sunlight through the air.

Around the launch pad you spot a Refuelling Station that looks like it could be used to fuel up the rocket. Running up the side of the metal tower is a Fuel Tube.

The Stairs going up the tower are to the West and Mission Control is to the North.

>n
Mission Control
A gigantic room filled with rows of moniters, each one manned by an Engineer or Scientist. In the front of the room is a large sceen constantly updating with news from all over the world and the status of the mission. In the corner you spot a Trash Can.

At the front of the room looks to be Greg the Head Scientist, to the west is the Storage room, and to the South is the Launch Pad.

>w
Storage Room
A small room filled with Space Suits and Space Helmets hung on the wall behind a Cage.

There look to be two exits one to the North, and one to the East.

You can see a partition and a Cage (empty) here.

>e
Mission Control
A gigantic room filled with rows of moniters, each one manned by an Engineer or Scientist. In the front of the room is a large sceen constantly updating with news from all over the world and the status of the mission. In the corner you spot a Trash Can.

At the front of the room looks to be Greg the Head Scientist, to the west is the Storage room, and to the South is the Launch Pad.

>s
Launch Pad
As you open the doors from mission control to go outside, you leave the airconditioned building behind. In the distance you see a giant Rocket of immense propotions. It's reflective surface glint beams of sunlight through the air.

Around the launch pad you spot a Refuelling Station that looks like it could be used to fuel up the rocket. Running up the side of the metal tower is a Fuel Tube.

The Stairs going up the tower are to the West and Mission Control is to the North.

>x tower
A tall metal structure next to the rocket, that helps to support it, as well as lets the Astronauts board the Space Shuttle when it is ready to launch.

To get to the top you must use the stairs to the West.

[Your score has just gone up by one point.]

>w
Stairs
Large wrought iron stairs that look to be the only way Up to the loading zone. It looks like it will be good exercise.

>u
Loading Zone
 A platform at the top of the metal tower. This platform is hundreds of feet in the air, and below you can seen the space base. From up here everything looks so small and the people below look like ants.

Across a large gap you see the rocket, but you cannont get to it yet.

Up here at the Loading Zone you can see a Control Pane which looks like it controls all the rocket's fuel tubes as well as the Launch Mecanism.

To get back to the Launch Pad use the stairs to go back down. 

You can see an Air Lock here.

>x launch mecanism
The action that starts the launch of the rocket.

[Your score has just gone up by one point.]

>pull launch mecanism
It is fixed in place.

>x control pane
On the control pane, you see the Launching Lever that controls the launch of the rocket and space shuttle.

[Your score has just gone up by one point.]

>pull launching lever
Now that the rocket is fueled and you are ready to go you are ready to launch. You put your space suit on and walk slowly to the rocket. The Airlock unlocks with a hiss of hydraulics and you step inside. You go up to the flight deck, and strap into your seat and get ready to launch.

  5.  4.  3.  2.  1.  We have liftoff…

 You suddenly feel the thrusters engage and the rocket starts to blast off with an ear shattering roar. The rocket starts to move faster and faster, and it feels like the skin on your face is being pulled back because of the force. As the ship rattles you hear a voice over the loudspeaker. "Detaching Rockets"
 The shuttle detaches from the rocket, and you have finally reached space.
 
Flight Deck
At the head of the Space Shuttle is the flight deck where the entirety of the ship is controlled. You see three seats, one for the captain, one for the engineer, and one for you although you are the only one on the mission.

In front of the seats is a thick Windsceen the protects you from outer space and allows you to see out the front so you can pilot the ship and use the Controls to the space shuttle.

>x controls
The controls for landing on the moon and manipulating the space shuttle.

[Your score has just gone up by one point.]

>d
Crew Compartment
You step inside the Space Shuttle to the Crew Compartment the place where spend most of your time living and working on your voyage. You can see your way through the metal room with the fluroscent lights illuminating your way. You now stand on one of the walls of the space shuttle, as there is no gravity.

In the Crew Compartment you spot some Beds, a Work Bench, and some storage Cabinets. Below you in the Space Shuttle is the Lower Deck, and Above you is the Flight Deck.

* * *

>open cabinets
In the cabinet, you see a flag, vodka, and a shovel.

>take flage, vodka
You can't see any such thing.

>take flag and vodka
Flag: As you look at the flag you realize you are not an American Astronaut, but a Russian one. You suddenly remember some of  the details of your mission. Go to the moon, claim it for the Motherland, and destroy all traces of the Americans.
Vodka: Taken.

>take shovel
Taken.

>drink vodka
[Your score has just gone up by one point.]

>drink the vodka
You can't see any such thing.

>i
You are carrying:
  a Shovel
  a Flag
  a launch command
  a token
  a Space Helmet (being worn)
  a Space Suit (being worn)
  a Master Key
  a wrench

>w
Airlock
A room that seperates space from the inner space ship.

With a hiss of hydraulics and pressure one side of the Airlock closes and the other opens.

>i
You are carrying:
  a Shovel
  a Flag
  a launch command
  a token
  a Space Helmet (being worn)
  a Space Suit (being worn)
  a Master Key
  a wrench

>w
OuterSpace
You float in space after leaving the shuttle and stare at the emptiness of space. You cannont hear anything except the crackle of your headset telling you to complete you mission by landing on the moon Below.

You remember a quote you once heard from a movie. "In space, no one can hear you scream. "

>e
Airlock
A room that seperates space from the inner space ship.

With a hiss of hydraulics and pressure one side of the Airlock closes and the other opens.

>i
You are carrying:
  a Shovel
  a Flag
  a launch command
  a token
  a Space Helmet (being worn)
  a Space Suit (being worn)
  a Master Key
  a wrench

* * *

>w
OuterSpace
You float in space after leaving the shuttle and stare at the emptiness of space. You cannont hear anything except the crackle of your headset telling you to complete you mission by landing on the moon Below.

You remember a quote you once heard from a movie. "In space, no one can hear you scream. "

>d
Moon Surface
A large expanse of land in space with giagantic craters strewn across the surface. You see the footprints of previous moon expeditions and across the way you see the American flag.

You also see a Hole in the ground that you might be able to open.

>open hole
You dig a hole in the moon with your shovel, which looks like the russian Flag can go in it.

>put flag in hole
(the Flag in Hole)

 You put the flag of the motherland in the hole and claim the Moon FOR RUSSIA!!! 

 Now that your mission is complete you radio back to mission control. "Thank you for your service to the Country. Your sacrafise will be remembered," says mission control over the radio.

 Remembered? I'm not dead yet.

 Suddenly, you have a hard time breathing, your oxygen supply seems to be depleating. BOOM! the space shuttle explodes behind you.

 In your last moments, you finally remember the mission details. 

 To go to the moon and plant Russia's flag. After completing your mission, your life will then be terminated as your use has ended… 

 

    *** You have won ***

In that game you scored 5 out of a possible 0, in 52 turns.

Would you like to RESTART, RESTORE a saved game, QUIT or UNDO the last command?