You wake up groggily from a hangover, and find yourself sitting on a toilet. All you can remember is that you are in the command center for a space program on Earth. Not remembering who you are, what your purpose is, or why you are here, confuses you greatly. You must find out…

From the Moon with Love
An Interactive Fiction by Matthew Shimura
Release 1 / Serial number 130318 / Inform 7 build 6G60 (I6/v6.32 lib 6/12N) SD

Bathroom
A spotless tiled restroom with many stalls and a large spanning mirror along the wall. It seems very peaceful here. In the back of the room you see a Utility Closet that looks to be used by the Janitor.

The exit to the Bathroom is to the East.

>x mirror
You look in the mirror and see yourself. You are a strapping lad of 20 something years. You have a long scar running down the side of you face from your right eyebrow to your chin. You also notice that you have a little hair stubble growing from your shaved head.

In the mirror, you also see a sickle and a hammer tattooed on your wrist.

[Your score has just gone up by one point.]

>x sickel
You can't see any such thing.

>x sickle
You can't see any such thing.

>x wrist
You can't see any such thing.

>x utility closet
A closet used for storing cleaning chemicals and a tools to keep the bathroom in working order.

[Your score has just gone up by one point.]

>x cleaning chemicals
You can't see any such thing.

>x tools
You can't see any such thing.

>x scar
A long scar that runs the length of your face.

>e
Training Room
In the training room you see a giant spinning Centrifuge in the middle of the room. Getting in the Centrifuge is a requirement of an astronaut to complete their training.

The bathroom is to the West, and the storage room is to the South.

You can see a hatch here.

>x centrifug
A giant spinning machine used to test the tolerance of Astronauts to acceleration for the conditions of space. Many fail and few succeed this challenges, and it is necessary for you to be approved to the next stage of the mission.

[Your score has just gone up by one point.]

>open centrifuge
That's not something you can open.

>x partition
You can't see any such thing.

>s
(first opening the hatch)
It seems to be locked.

>south
(first opening the hatch)
It seems to be locked.

>open partition
You can't see any such thing.

>l
Training Room
In the training room you see a giant spinning Centrifuge in the middle of the room. Getting in the Centrifuge is a requirement of an astronaut to complete their training.

The bathroom is to the West, and the storage room is to the South.

You can see a hatch here.

>"Getting in the centrifuge is a required of an astronaut?"
That's not a verb I recognise.

>w
Bathroom
A spotless tiled restroom with many stalls and a large spanning mirror along the wall. It seems very peaceful here. In the back of the room you see a utility closet that looks to be used by the Janitor.

The exit to the Bathroom is to the East.

>x tiles
Shiny blue mosaic tiles that line the floor in tiny rows. They are slippery because they look like they have been mopped recently.

On the floor you see a wallet.

[Your score has just gone up by one point.]

>take wallet
Is this your wallet? Maybe you are an astronaut?

>take wallet
You already have that.

>x wallet
A wallet with 3,047 rubles in it. The wallet belongs to a young astronaut named, Victor Sasha Reznov.

As you open the wallet, a Crumpled Paper falls to the floor.

[Your score has just gone up by one point.]

>x crumpled paper
On the crumpled paper you see "Mission Details: To go to the moon and plant…" You cannot read the rest.

You might want to save this for later."

>take paper
Taken.

>take crumpled paper
You already have that.

>take
What do you want to take?

>take toilet paper
I only understood you as far as wanting to take the Toilet.

>x toilet paper
I only understood you as far as wanting to examine the Toilet.

>l
Bathroom
A spotless tiled restroom with many stalls and a large spanning mirror along the wall. It seems very peaceful here. In the back of the room you see a utility closet that looks to be used by the Janitor.

The exit to the Bathroom is to the East.

>take mirror
That's hardly portable.

>x mirror
You look in the mirror and see yourself. You are a strapping lad of 20 something years. You have a long scar running down the side of you face from your right eyebrow to your chin. You also notice that you have a little hair stubble growing from your shaved head.

In the mirror, you also see a sickle and a hammer tattooed on your wrist.

>open closet door
I only understood you as far as wanting to open the utility closet.

>open utility closet
You open the utility closet and reveal some chemicals and a wrench.

>take wrench
Taken.

>take chemicals
Taken.

>use chemicals
That's not a verb I recognise.

>use wrench
That's not a verb I recognise.

>l
Bathroom
A spotless tiled restroom with many stalls and a large spanning mirror along the wall. It seems very peaceful here. In the back of the room you see a utility closet that looks to be used by the Janitor.

The exit to the Bathroom is to the East.

>e
Training Room
In the training room you see a giant spinning Centrifuge in the middle of the room. Getting in the Centrifuge is a requirement of an astronaut to complete their training.

The bathroom is to the West, and the storage room is to the South.

You can see a hatch here.

>s
(first opening the hatch)
It seems to be locked.

>open storage room with wrench
You can't see any such thing.

>x me
You can't see yourself without something reflective

>s
(first opening the hatch)
It seems to be locked.

>get in centrifuge
You get into the centrifuge and it spins round and round until your stomach feels like it is going to bust open. You get very queazy and feel like you almost want to barf.

 Finally, the spinning stops, and you get out of the centrifuge.  You hear the click of the hatch unlocking.

>barf
That's not a verb I recognise.

>get out of centrifuge
I only understood you as far as wanting to get outside.

>s
(first opening the hatch)

Storage Room
A small room filled with Space Suits and Space Helmets hung on the wall behind a Cage.

There look to be two exits one to the North, and one to the East.

You can see a hatch here.

>open cage
It seems to be locked.

>open cage with wrench
That doesn't seem to fit the lock.

>x space suits
You can't see any such thing.

>x space helmets
You can't see any such thing.

>x cage
A chain link cage which inside of you see space suits and a space helmet.

[Your score has just gone up by one point.]

>take suits
You can't see any such thing.

>take space helmet
You can't see any such thing.

>e
Mission Control
A gigantic room filled with rows of monitors, each one manned by an Engineer or Scientist. In the front of the room is a large screen constantly updating with news from all over the world and the status of the mission. In the corner you spot a Trash Can.

At the front of the room looks to be Greg the Head Scientist, to the west is the Storage room, and to the South is the Launch Pad.

>x engineer
You see an engineer putting parts together to form useful items used to repair a spaceship in case of an emergency.

[Your score has just gone up by one point.]

>x scientist
You see a scientist in a white lab coat furiously working on some mathematical calculations that predict the trajectory of the rocket after reaching critical altitude.

[Your score has just gone up by one point.]

>hint
That's not a verb I recognise.

>x large screen
Large led screens showing a map of the world with important news stories popping up every few minutes. You look closely to the screen and see that the writing is in Russian, but you seem to understand it.

[Your score has just gone up by one point.]

>x screen
Large led screens showing a map of the world with important news stories popping up every few minutes. You look closely to the screen and see that the writing is in Russian, but you seem to understand it.

>x monitors
State of the art computers used by the scientists and engineers. They hold all the blueprints and mission details of your space trip.

[Your score has just gone up by one point.]

>x trash can
A plain plastic trash can. Inside it you can see a piece of Ripped Paper.

[Your score has just gone up by one point.]

>change ripper to ripped
That's not a verb I recognise.

>x ripped paper
On the ripped paper you make out the words "…your life will then…ou make out the words "

The rest of the message is missing.

>take ripped paper
Taken.

>i
You are carrying:
  a Ripped Paper
  a chemicals
  a wrench
  a Crumpled Paper
  a wallet

>x crumpled paper
On the crumpled paper you see "Mission Details: To go to the moon and plant…" You cannot read the rest.

You might want to save this for later."

>x ripped paper
On the ripped paper you make out the words "…your life will then…ou make out the words "

The rest of the message is missing.

>l
Mission Control
A gigantic room filled with rows of monitors, each one manned by an Engineer or Scientist. In the front of the room is a large screen constantly updating with news from all over the world and the status of the mission. In the corner you spot a Trash Can.

At the front of the room looks to be Greg the Head Scientist, to the west is the Storage room, and to the South is the Launch Pad.

>x greg
Greg is the Head Scientist of the Space Program. He is a short man with cropped brown hair, and thick spectacles. Greg looks very intelligent and double majored in aeronautical engineerings and rocket science in school.

>talk to greg
"Hi there, I'm Greg the Head Scientist. You must be the new astronaut. I'm very busy right now, but I must tell you what you need to do for your mission to the moon. First you must acquire you space suit." Greg opens his hand, and offers you the master key.

>take master key
"Now that you have the key, you can go get your Space Suit and Helmet. Come back to me when you have done that."

>take space suit
You can't see any such thing.

>take all
Hey stop that! All is disabled.

>x helmet
You can't see any such thing.

>l
Mission Control
A gigantic room filled with rows of monitors, each one manned by an Engineer or Scientist. In the front of the room is a large screen constantly updating with news from all over the world and the status of the mission. In the corner you spot a Trash Can.

At the front of the room looks to be Greg the Head Scientist, to the west is the Storage room, and to the South is the Launch Pad.

>s
Launch Pad
As you open the doors from mission control to go outside, you leave the air conditioned building behind. In the distance you see a giant Rocket of immense proportions. It's reflective surface glint beams of sunlight through the air.

Around the launch pad you spot a Refueling Station that looks like it could be used to fuel up the rocket. Running up the side of the metal tower is a Fuel Tube.

The Stairs going up the tower are to the West and Mission Control is to the North.

>x fuel tube
A thick metal fuel tube which looks like it runs the length of the metal tower from the refueling station to the rocket.

It looks doesn't seem to be running right now.

>x rocket
Towering above you is a rocket of massive proportions. The fuel chambers and thrusters go hundreds of feet into the sky. It looks like it could withstand even the harshest of conditions and is built to last.

Mounted on the Rocket is a Space Shuttle.

[Your score has just gone up by one point.]

>x refeuling station
You can't see any such thing.

>x refueling station
A crucial part of the launch pad where carbon rich rocket fuel flows from the refueling station to the Rocket. Right now it does not seem to be working, as the Valve looks to be broken.

>x valve
The opening of the refueling station that lets the rocket fuel out. The valve looks broken and could be fixed.

[Your score has just gone up by one point.]

>l
Launch Pad
As you open the doors from mission control to go outside, you leave the air conditioned building behind. In the distance you see a giant Rocket of immense proportions. It's reflective surface glint beams of sunlight through the air.

Around the launch pad you spot a Refueling Station that looks like it could be used to fuel up the rocket. Running up the side of the metal tower is a Fuel Tube.

The Stairs going up the tower are to the West and Mission Control is to the North.

>w
Stairs
Large wrought iron stairs that look to be the only way Up to the loading zone. It looks like it will be good exercise

To the west is the Launch Pad.

>x up
You see nothing unexpected in that direction.

>up
Loading Zone
 A platform at the top of the metal tower. This platform is hundreds of feet in the air, and below you can seen the space base. From up here everything looks so small and the people below look like ants. Across a large gap, you see the rocket, but you cannot get to it yet.

Up here at the Loading Zone you can see a Control Pane which looks like it controls all the rocket's fuel tubes as well as the Launch Mechanism.

To get back to the Launch Pad use the stairs to go back Down.

>x control pane
On the control pane, you see the Launching Lever that controls the launch of the rocket and space shuttle.

[Your score has just gone up by one point.]

>x air lock
You can't see any such thing.

>l
Loading Zone
 A platform at the top of the metal tower. This platform is hundreds of feet in the air, and below you can seen the space base. From up here everything looks so small and the people below look like ants. Across a large gap, you see the rocket, but you cannot get to it yet.

Up here at the Loading Zone you can see a Control Pane which looks like it controls all the rocket's fuel tubes as well as the Launch Mechanism.

To get back to the Launch Pad use the stairs to go back Down.

>d
Stairs
Large wrought iron stairs that look to be the only way Up to the loading zone. It looks like it will be good exercise

To the west is the Launch Pad.

>e
Launch Pad
As you open the doors from mission control to go outside, you leave the air conditioned building behind. In the distance you see a giant Rocket of immense proportions. It's reflective surface glint beams of sunlight through the air.

Around the launch pad you spot a Refueling Station that looks like it could be used to fuel up the rocket. Running up the side of the metal tower is a Fuel Tube.

The Stairs going up the tower are to the West and Mission Control is to the North.

>n
Mission Control
A gigantic room filled with rows of monitors, each one manned by an Engineer or Scientist. In the front of the room is a large screen constantly updating with news from all over the world and the status of the mission. In the corner you spot a Trash Can.

At the front of the room looks to be Greg the Head Scientist, to the west is the Storage room, and to the South is the Launch Pad.

>w
Storage Room
A small room filled with Space Suits and Space Helmets hung on the wall behind a Cage.

There look to be two exits one to the North, and one to the East.

You can see a hatch here.

>take space suits
You can't see any such thing.

>take space suit
You can't see any such thing.

>open cage
It seems to be locked.

>open cage
It seems to be locked.

>e
Mission Control
A gigantic room filled with rows of monitors, each one manned by an Engineer or Scientist. In the front of the room is a large screen constantly updating with news from all over the world and the status of the mission. In the corner you spot a Trash Can.

At the front of the room looks to be Greg the Head Scientist, to the west is the Storage room, and to the South is the Launch Pad.

>x trash can
A plain plastic trash can. Inside it you can see a piece of Ripped Paper.

>talk to greg
Come back to me when you have completed the missions I gave you.

>w
Storage Room
A small room filled with Space Suits and Space Helmets hung on the wall behind a Cage.

There look to be two exits one to the North, and one to the East.

You can see a hatch here.

>open cage with master key
You unlock the Cage.

>x cage
A chain link cage which inside of you see space suits and a space helmet.

>take suit
You can't see any such thing.

>take space suits
You can't see any such thing.

* * *

>take space suit
You can't see any such thing.

>take space helmet
You can't see any such thing.

>go into cage
That's not something you can enter.

>enter cage
That's not something you can enter.

>x cage
A chain link cage which inside of you see space suits and a space helmet.

>l
Storage Room
A small room filled with Space Suits and Space Helmets hung on the wall behind a Cage.

There look to be two exits one to the North, and one to the East.

You can see a hatch here.

>open cage with master key
That's unlocked at the moment.

>l
Storage Room
A small room filled with Space Suits and Space Helmets hung on the wall behind a Cage.

There look to be two exits one to the North, and one to the East.

You can see a hatch here.

>open cage
You open the Cage, revealing a Space Suit and a Space Helmet.

>take space suit
Now that you have your space suit you can return to Greg.

>take helmet
Taken.

>e
Mission Control
A gigantic room filled with rows of monitors, each one manned by an Engineer or Scientist. In the front of the room is a large screen constantly updating with news from all over the world and the status of the mission. In the corner you spot a Trash Can.

At the front of the room looks to be Greg the Head Scientist, to the west is the Storage room, and to the South is the Launch Pad.

>put on helmet
[Your score has just gone up by one point.]

>put on space suit
[Your score has just gone up by one point.]

>talk to greg
Come back to me when you have completed the missions I gave you.

>e
You can't go that way.

>w
Storage Room
A small room filled with Space Suits and Space Helmets hung on the wall behind a Cage.

There look to be two exits one to the North, and one to the East.

You can see a hatch here.

>e
Mission Control
A gigantic room filled with rows of monitors, each one manned by an Engineer or Scientist. In the front of the room is a large screen constantly updating with news from all over the world and the status of the mission. In the corner you spot a Trash Can.

At the front of the room looks to be Greg the Head Scientist, to the west is the Storage room, and to the South is the Launch Pad.

>s
Launch Pad
As you open the doors from mission control to go outside, you leave the air conditioned building behind. In the distance you see a giant Rocket of immense proportions. It's reflective surface glint beams of sunlight through the air.

Around the launch pad you spot a Refueling Station that looks like it could be used to fuel up the rocket. Running up the side of the metal tower is a Fuel Tube.

The Stairs going up the tower are to the West and Mission Control is to the North.

>w
Stairs
Large wrought iron stairs that look to be the only way Up to the loading zone. It looks like it will be good exercise

To the west is the Launch Pad.

>u
Loading Zone
 A platform at the top of the metal tower. This platform is hundreds of feet in the air, and below you can seen the space base. From up here everything looks so small and the people below look like ants. Across a large gap, you see the rocket, but you cannot get to it yet.

Up here at the Loading Zone you can see a Control Pane which looks like it controls all the rocket's fuel tubes as well as the Launch Mechanism.

To get back to the Launch Pad use the stairs to go back Down.

>d
Stairs
Large wrought iron stairs that look to be the only way Up to the loading zone. It looks like it will be good exercise

To the west is the Launch Pad.

* * *

>e
Launch Pad
As you open the doors from mission control to go outside, you leave the air conditioned building behind. In the distance you see a giant Rocket of immense proportions. It's reflective surface glint beams of sunlight through the air.

Around the launch pad you spot a Refueling Station that looks like it could be used to fuel up the rocket. Running up the side of the metal tower is a Fuel Tube.

The Stairs going up the tower are to the West and Mission Control is to the North.

>fix refueling station with wrench
I didn't understand that sentence.

>fix station
I didn't understand that sentence.

>x station
A crucial part of the launch pad where carbon rich rocket fuel flows from the refueling station to the Rocket. Right now it does not seem to be working, as the Valve looks to be broken.

>fix valve
You fix the valve with your wrench. You feel a rumble under the ground and suddenly the rocket fuel starts to flow from the refueling station, to the fuel tube, and to the rocket.

 You seem to have refueled the rocket and should now return to Greg.

>w
Stairs
Large wrought iron stairs that look to be the only way Up to the loading zone. It looks like it will be good exercise

To the west is the Launch Pad.

>e
Launch Pad
As you open the doors from mission control to go outside, you leave the air conditioned building behind. In the distance you see a giant Rocket of immense proportions. It's reflective surface glint beams of sunlight through the air.

Around the launch pad you spot a Refueling Station that looks like it could be used to fuel up the rocket. Running up the side of the metal tower is a Fuel Tube.

The Stairs going up the tower are to the West and Mission Control is to the North.

* * *

>n
Mission Control
A gigantic room filled with rows of monitors, each one manned by an Engineer or Scientist. In the front of the room is a large screen constantly updating with news from all over the world and the status of the mission. In the corner you spot a Trash Can.

At the front of the room looks to be Greg the Head Scientist, to the west is the Storage room, and to the South is the Launch Pad.

>talk to greg
"You are now ready to go to the rocket. Here is the launch command." Greg opens the hand and offers you the launch command.

>take launch command
"Now go to the loading zone and pull the Launching Lever."

>s
Launch Pad
As you open the doors from mission control to go outside, you leave the air conditioned building behind. In the distance you see a giant Rocket of immense proportions. It's reflective surface glint beams of sunlight through the air.

Around the launch pad you spot a Refueling Station that looks like it could be used to fuel up the rocket. Running up the side of the metal tower is a Fuel Tube.

The Stairs going up the tower are to the West and Mission Control is to the North.

>launch rocket
That's not a verb I recognise.

>w
Stairs
Large wrought iron stairs that look to be the only way Up to the loading zone. It looks like it will be good exercise

To the west is the Launch Pad.

* * *

>e
Launch Pad
As you open the doors from mission control to go outside, you leave the air conditioned building behind. In the distance you see a giant Rocket of immense proportions. It's reflective surface glint beams of sunlight through the air.

Around the launch pad you spot a Refueling Station that looks like it could be used to fuel up the rocket. Running up the side of the metal tower is a Fuel Tube.

The Stairs going up the tower are to the West and Mission Control is to the North.

>w
Stairs
Large wrought iron stairs that look to be the only way Up to the loading zone. It looks like it will be good exercise

To the west is the Launch Pad.

* * *

>u
Loading Zone
 A platform at the top of the metal tower. This platform is hundreds of feet in the air, and below you can seen the space base. From up here everything looks so small and the people below look like ants. Across a large gap, you see the rocket, but you cannot get to it yet.

Up here at the Loading Zone you can see a Control Pane which looks like it controls all the rocket's fuel tubes as well as the Launch Mechanism.

To get back to the Launch Pad use the stairs to go back Down.

>launch rocket
That's not a verb I recognise.

>x air lock
You can't see any such thing.

>go into air lock
You can't see any such thing.

>unlock air lock with command
You can't see any such thing.

>x control pane
On the control pane, you see the Launching Lever that controls the launch of the rocket and space shuttle.

>use launching lever
That's not a verb I recognise.

>pull launching lever
Now that the rocket is fueled and you are ready to go you are ready to launch. You put your space suit on and walk slowly to the rocket. The Airlock unlocks with a hiss of hydraulics and you step inside. You go up to the flight deck, and strap into your seat and get ready to launch.

  5.  4.  3.  2.  1.  We have liftoff…

 You suddenly feel the thrusters engage and the rocket starts to blast off with an ear shattering roar. The rocket starts to move faster and faster, and it feels like the skin on your face is being pulled back because of the force. As the ship rattles you hear a voice over the loudspeaker. "Detaching Rockets"
 The shuttle detaches from the rocket, and you have finally reached space.
 
Flight Deck
At the head of the Space Shuttle is the flight deck where the entirety of the ship is controlled. You see one seat for you since you are the only one on the Mission.

In front of the seats is a thick Windscreen the protects you from outer space and allows you to see out the front so you can pilot the ship and use the Controls to the space shuttle.

Below the Flight deck is the Crew Compartment.

>x windscreen
You look out of the windscreen at the vast expanse of space. From here you can see the Moon.

[Your score has just gone up by one point.]

>x controls
The controls for landing on the moon and manipulating the space shuttle.

[Your score has just gone up by one point.]

>l
Flight Deck
At the head of the Space Shuttle is the flight deck where the entirety of the ship is controlled. You see one seat for you since you are the only one on the Mission.

In front of the seats is a thick Windscreen the protects you from outer space and allows you to see out the front so you can pilot the ship and use the Controls to the space shuttle.

Below the Flight deck is the Crew Compartment.

>x seats
You see three seats on the Flight Deck. They look to be very comfy because of all the padded cushion.

[Your score has just gone up by one point.]

>sit on seat
You can't see any such thing.

>sit on my seat
You can't see any such thing.

>sit
What do you want to sit on?

>sit in seat
You can't see any such thing.

>enter seat
You can't see any such thing.

>d
Crew Compartment
You step inside the Space Shuttle to the Crew Compartment the place where spend most of your time living and working on your voyage. You can see your way through the metal room with the fluorescent lights illuminating your way. You now stand on one of the walls of the space shuttle, as there is no gravity.

In the Crew Compartment you spot some Beds, a Work Bench, and some storage Cabinets. Below you in the Space Shuttle is the Lower Deck, and Above you is the Flight Deck.

>x beds
A bed mounted against the wall which looks sleepable but not comfy. It looks like whoever built the space shuttle spared no expense it making it livable.

[Your score has just gone up by one point.]

>x work bench
A wooden counter retrofitted to remind you of home. The surface of the wood is marred with scratches likely from tools being used.

This work bench looks like it can be used to assemble things once the required parts and tools are acquired.

[Your score has just gone up by one point.]

>x cabinets
A thick metal cabinet that solidly rings when you tap on it. It looks like it could hold some things needed for you mission on the Moon.

[Your score has just gone up by one point.]

>x below
You can't see any such thing.

>x space shuttle
You can't see any such thing.

>take key
You already have that.

>tap on cabinet
That's not a verb I recognise.

>open cabinet
In the cabinet, you see a flag, vodka, and a shovel.

>take vodka
Taken.

>drink vodka
[Your score has just gone up by one point.]

>take flag
As you look at the flag you realize you are not an American Astronaut, but a Russian one. You suddenly remember some of  the details of your mission. Go to the moon, claim it for the Motherland, and destroy all traces of the Americans.

>eat flag
That's plainly inedible.

>take shovel
Taken.

>eat shovel
That's plainly inedible.

I beg your pardon?

>l
Crew Compartment
You step inside the Space Shuttle to the Crew Compartment the place where spend most of your time living and working on your voyage. You can see your way through the metal room with the fluorescent lights illuminating your way. You now stand on one of the walls of the space shuttle, as there is no gravity.

In the Crew Compartment you spot some Beds, a Work Bench, and some storage Cabinets. Below you in the Space Shuttle is the Lower Deck, and Above you is the Flight Deck.

>s
You can't go that way.

>d
Lower Deck
The Lower deck of the crew compartment holds the Engines of the ship and its Thrusters. You can hear the humming of machines and the occasional beep of a notice going off. On the ground you spot a scrap of Paper.

Without the lower deck working properly the space shuttle could not move around space. In the lower deck you spot a window.

Above you is the crew compartment.

>take paper
(the Burnt Paper)
Taken.

>read paper
Which do you mean, the Burnt Paper, the Ripped Paper or the Crumpled Paper?

>x toilet paper
You can't see any such thing.

>x burnt paper
a shred of paper that seems to be ripped. You can make out from the remnants the words "..be terminated."

>x crunpled paper
You can't see any such thing.

>x crumpled
On the crumpled paper you see "Mission Details: To go to the moon and plant…" You cannot read the rest.

You might want to save this for later."

>x ripped
On the ripped paper you make out the words "…your life will then…ou make out the words "

The rest of the message is missing.

>x burnt
a shred of paper that seems to be ripped. You can make out from the remnants the words "..be terminated."

>l
Lower Deck
The Lower deck of the crew compartment holds the Engines of the ship and its Thrusters. You can hear the humming of machines and the occasional beep of a notice going off. On the ground you spot a scrap of Paper.

Without the lower deck working properly the space shuttle could not move around space. In the lower deck you spot a window.

Above you is the crew compartment.

>take paper
Which do you mean, the Burnt Paper, the Ripped Paper or the Crumpled Paper?

>take burnt paper
You already have that.

>l
Lower Deck
The Lower deck of the crew compartment holds the Engines of the ship and its Thrusters. You can hear the humming of machines and the occasional beep of a notice going off. On the ground you spot a scrap of Paper.

Without the lower deck working properly the space shuttle could not move around space. In the lower deck you spot a window.

Above you is the crew compartment.

>x window
You look out of window and see the earth circling beneath you. On Earth, it is night, but you can see beacons of light from all of the major cities of the world.

[Your score has just gone up by one point.]

>up
Crew Compartment
You step inside the Space Shuttle to the Crew Compartment the place where spend most of your time living and working on your voyage. You can see your way through the metal room with the fluorescent lights illuminating your way. You now stand on one of the walls of the space shuttle, as there is no gravity.

In the Crew Compartment you spot some Beds, a Work Bench, and some storage Cabinets. Below you in the Space Shuttle is the Lower Deck, and Above you is the Flight Deck.

>slepe
That's not a verb I recognise.

>sleep
You aren't feeling especially drowsy.

>sleep on bed
I only understood you as far as wanting to sleep.

>enter beds
You get onto the Beds.

>sleep
You aren't feeling especially drowsy.

>x
What do you want to examine?

>l
Crew Compartment (on the Beds)
You step inside the Space Shuttle to the Crew Compartment the place where spend most of your time living and working on your voyage. You can see your way through the metal room with the fluorescent lights illuminating your way. You now stand on one of the walls of the space shuttle, as there is no gravity.

In the Crew Compartment you spot some Beds, a Work Bench, and some storage Cabinets. Below you in the Space Shuttle is the Lower Deck, and Above you is the Flight Deck.

>w
(first getting off the Beds)

Airlock
A room that separates space from the inner space ship. East of the Airlock is Outer Space and West of the Airlock is the Crew Compartment.

With a hiss of hydraulics and pressure one side of the Airlock closes and the other opens.

>open airlock
You can't see any such thing.

>w
OuterSpace
You float in space after leaving the shuttle and stare at the emptiness of space. You cannot hear anything except the crackle of your headset telling you to complete you mission by landing on the moon Below. Back West is the Airlock.

You remember a quote you once heard from a movie. "In space, no one can hear you scream. "

>e
Airlock
A room that separates space from the inner space ship. East of the Airlock is Outer Space and West of the Airlock is the Crew Compartment.

With a hiss of hydraulics and pressure one side of the Airlock closes and the other opens.

>w
OuterSpace
You float in space after leaving the shuttle and stare at the emptiness of space. You cannot hear anything except the crackle of your headset telling you to complete you mission by landing on the moon Below. Back West is the Airlock.

You remember a quote you once heard from a movie. "In space, no one can hear you scream. "

>down
Moon Surface
A large expanse of land in space with gigantic craters strewn across the surface. You see the footprints of previous moon expeditions and across the way you see the American flag. Above you is OuterSpace.

You also see a Hole in the ground that you might be able to open.

>plant flag
That's not a verb I recognise.

>put flag in hole
(the Flag in Hole)

 You put the flag of the motherland in the hole and claim the Moon FOR RUSSIA!!! 

 Now that your mission is complete you radio back to mission control. "Thank you for your service to the Country. Your sacrifice will be remembered," says mission control over the radio.

 Remembered? I'm not dead yet.

 Suddenly, you have a hard time breathing, your oxygen supply seems to be depleting.  BOOM!  The space shuttle explodes behind you.

 In your last moments, you finally remember the mission details. 

 To go to the moon and plant Russia's flag. After completing your mission, your life will then be terminated as your use has ended… 摡潩戠捡⁫潴洠獩楳湯挠湯牴汯‮吢慨歮礠畯映牯礠畯⁲敳 you have a hard time breathing, your oxygen supply se䤠洧渠瑯搠慥⁤敹⹴ਊ
 

    *** You have won ***

In that game you scored 24 out of a possible 53, in 147 turns.

Would you like to RESTART, RESTORE a saved game, QUIT or UNDO the last command?

* * *

>x floor
Shiny blue mosaic tiles that line the floor in tiny rows. They are slippery because they look like they have been mopped recently.

On the floor you see a wallet.

[Your score has just gone up by one point.]

>take wallet
Is this your wallet? Maybe you are an astronaut?

>x wallet
A wallet with 3,047 rubles in it. The wallet belongs to a young astronaut named, Victor Sasha Reznov.

As you open the wallet, a Crumpled Paper falls to the floor.

[Your score has just gone up by one point.]

>take crumpled paper
Taken.

>e
Training Room
In the training room you see a giant spinning Centrifuge in the middle of the room. Getting in the Centrifuge is a requirement of an astronaut to complete their training.

The bathroom is to the West, and the storage room is to the South.

You can see a hatch here.

>get in centrifuge
You get into the centrifuge and it spins round and round until your stomach feels like it is going to bust open. You get very queasy and feel like you almost want to barf.

 Finally, the spinning stops, and you get out of the centrifuge.  You hear the click of the hatch unlocking.

>x hatch
Only astronauts that have finished their training can go past this door that leads to the Storage Room.

[Your score has just gone up by one point.]

>s
(first opening the hatch)

Storage Room
A small room filled with a Cage that holds important materials.

There look to be two exits one to the North, and one to the East.

You can see a hatch here.

>e
Mission Control
A gigantic room filled with rows of monitors, each one manned by an Engineer or Scientist. In the front of the room is a large screen constantly updating with news from all over the world and the status of the mission. In the corner, you spot a trashcan.

At the front of the room looks to be Greg the Head Scientist

To the West is the Storage room, and to the South is the Launch Pad.

>x trashcan
A plain plastic trash can. Inside it, you can see a piece of Ripped Paper.

[Your score has just gone up by one point.]

>take ripped paper
Taken.

>take ripper paper
You can't see any such thing.

>i
You are carrying:
  a Ripped Paper
  a Crumpled Paper
  a Wallet

>take launch command
"Now, go to the loading zone and pull the Launching Lever."

>talk to greg
"Hi there, I'm Greg the Head Scientist. You must be the new astronaut. I'm very busy right now, but I must tell you what you need to do for your mission to the moon. First, you must acquire you space suit." Greg opens his hand, and offers you the master key.

>s
Launch Pad
As you open the doors from mission control to go outside, you leave the air conditioned building behind. In the distance, you see a giant Rocket of immense proportions. It's reflective surface glint beams of sunlight through the air.

Around the launch pad, you spot a Refueling Station that looks like it could be used to fuel up the rocket. Running up the side of the metal tower is a Fuel Tube.

The Stairs going up the tower are to the West and Mission Control is to the North.

>w
Stairs
Large wrought iron stairs that look to be the only way Up to the loading zone and back East is the launch pad. On the stairs, you see a piece of Shredded Paper.

Taking the stairs looks like it will be good exercise for your leg muscles.

>take shredded paper
Taken.

>u
Loading Zone
 A platform at the top of the metal tower. This platform is hundreds of feet in the air, and below you can see the space base. From up here everything looks so small and the people below look like ants. Across a large gap, you see the rocket, but you cannot get to it yet.

Up here at the Loading Zone, you can see a Control Pane that looks like it controls all the rocket's fuel tubes and contains the Launching Lever.

To get back to the Launch Pad use the stairs to go back Down.

>pull launching leve
I only understood you as far as wanting to pull the Launching Lever.

>pull launching lever
Now that the rocket is fueled and you are ready to go you are ready to launch. You put your space suit on and walk slowly to the rocket. The Airlock unlocks with a hiss of hydraulics and you step inside. You go up to the flight deck, and strap into your seat and get ready to launch.

  5.  4.  3.  2.  1.  We have liftoff…

 You suddenly feel the thrusters engage and the rocket starts to blast off with an ear-shattering roar. The rocket starts to move faster and faster, and it feels like the skin on your face is being pulled back because of the force. As the ship rattles, you hear a voice over the loudspeaker. "Detaching Rockets"

 The shuttle detaches from the rocket, and you have finally reached space.
 
Flight Deck
At the head of the Space Shuttle is the flight deck where the entirety of the ship is controlled. You see one seat for you, since you are the only one on the Mission.

In front of the Flight Deck is a thick Windscreen that protects you from outer space and allows you to see out the front so you can pilot the ship. You also see the controls.

Below the Flight Deck is the Crew Compartment.

>x controls
The controls for landing on the moon and manipulating the space shuttle.

[Your score has just gone up by one point.]

>down
Crew Compartment
You step inside the Space Shuttle to the Crew Compartment the place where spend most of your time living and working on your voyage. You can see your way through the metal room with the fluorescent lights illuminating your way. You now stand on one of the walls of the space shuttle, as there is no gravity.

In the Crew Compartment, you spot some beds and some storage Cabinets.

Below you in the Space Shuttle is the Lower Deck, Above you is the Flight Deck, and leading West is the Airlock which you will need to pass through to get to space.

>w
Airlock
A room that separates space from the inner space ship. West of the Airlock is Outer Space and East of the Airlock is the Crew Compartment.

With a hiss of hydraulics and pressure one side of the Airlock closes and the other opens.

>w
OuterSpace
You float in space after leaving the shuttle and stare at the emptiness of space. Floating in space with you is a piece of Folded Paper.

You remember a quote you once heard from a movie. "In space, no one can hear you scream.  You cannot hear anything except the crackle of your headset telling you to complete you mission by landing on the moon Below. Back East is the Airlock."

>take folded paper
Taken.

>e
Airlock
A room that separates space from the inner space ship. West of the Airlock is Outer Space and East of the Airlock is the Crew Compartment.

With a hiss of hydraulics and pressure one side of the Airlock closes and the other opens.

>d
You can't go that way.

>e
Crew Compartment
You step inside the Space Shuttle to the Crew Compartment the place where spend most of your time living and working on your voyage. You can see your way through the metal room with the fluorescent lights illuminating your way. You now stand on one of the walls of the space shuttle, as there is no gravity.

In the Crew Compartment, you spot some beds and some storage Cabinets.

Below you in the Space Shuttle is the Lower Deck, Above you is the Flight Deck, and leading West is the Airlock which you will need to pass through to get to space.

>d
Lower Deck
The Lower deck of the crew compartment holds the Engines of the ship and its Thrusters. You can hear the humming of machines and the occasional beep of a notice going off.

Without the lower deck working properly the space shuttle could not move around space. In the lower deck, you spot a window.

Above you is the crew compartment.

>x paper
Which do you mean, the Burnt Paper, the Folded Paper, the Shredded Paper, the Ripped Paper or the Crumpled Paper?

>x window
You look out of window and see the earth circling beneath you. On Earth, it is night, but you can see beacons of light from all of the major cities of the world.

On the windowsill you spot a piece of Burnt Paper.

[Your score has just gone up by one point.]

>i
You are carrying:
  a Folded Paper
  a Space Helmet (being worn)
  a Space Suit (being worn)
  a Shredded Paper
  a Launch Command
  a Ripped Paper
  a Crumpled Paper
  a Wallet

>take burnt paper
Taken.

>x crumpled paper
On the crumpled paper you see  "Mission Details: To go to the moon and plant…" You cannot read the rest.

You might want to save this for later."

>x folded paper
You unfold the paper and see that it says, "…Russiaold th's Flag. After completing your mission… " 

The message cuts off there.

>x ripped paper
On the ripped paper you make out the words "…your life will then…ou make out " 

The rest of the message is missing.

>x burnt paper
A burnt scrap of paper that seems to be ripped. You can make out from the remnants the words "...be terminated…paper "

The rest is too charred to read.

>x shredded paper
On the shredded paper you see the words, "…as your use has ended.ou see" 

It looks to be the end of the message.

>xyzzy
Monkeys are tasty.

* * *

>take wallet
Is this your wallet? Maybe you are an astronaut?

>smell odor
You smell nothing unexpected.

>smell chemicals
You smell nothing unexpected.

* * *

>open closet
You open the utility closet and reveal some chemicals and a wrench.

>take wrench
Taken.

>e
Training Room
In the training room you see a giant spinning Centrifuge in the middle of the room. Getting in the Centrifuge is a requirement of an astronaut to complete their training.

The bathroom is to the West, and the storage room is to the South.

You can see a hatch here.

* * *

>get in centrifuge
You get into the centrifuge and it spins round and round until your stomach feels like it is going to bust open. You get very queasy and feel like you almost want to barf.

 Finally, the spinning stops, and you get out of the centrifuge.  You hear the click of the hatch unlocking.

>s
(first opening the hatch)

Storage Room
A small room filled with a Cage that holds important materials.

There look to be two exits one to the North, and one to the East.

You can see a hatch here.

* * *

>e
Mission Control
A gigantic room filled with rows of monitors, each one manned by an Engineer or Scientist. In the front of the room is a large screen constantly updating with news from all over the world and the status of the mission. In the corner, you spot a trashcan.

At the front of the room looks to be Greg the Head Scientist

To the West is the Storage room, and to the South is the Launch Pad.

>s
Launch Pad
As you open the doors from mission control to go outside, you leave the airconditioned building behind. In the distance you see a giant Rocket of immense propotions. It's reflective surface glint beams of sunlight through the air.

Around the launch pad you spot a Refuelling Station that looks like it could be used to fill up the rocket. Connected to the rocket is a metal tower with a Elevator which looks like it could be used to get to the Loading zone. Running up the side of the metal tower is a Fuel Tube.

The Stairs are to the West.

>fix the valve
You fix the valve with your wrench. You feel a rumble under the ground and suddenly the rocket fuel starts to flow from the refueling station, to the fuel tube, and to the rocket.
 You seem to have refueled the rocket and should now return to Greg.

>fix valve
You fix the valve with your wrench. You feel a rumble under the ground and suddenly the rocket fuel starts to flow from the refueling station, to the fuel tube, and to the rocket.
 You seem to have refueled the rocket and should now return to Greg.

>n
Mission Control
A gigantic room filled with rows of moniters, each one manned by an Engineer or Scientist. In the front of the room is a large sceen constantly updating with news from all over the world and the status of the mission.

At the front of the room looks to be Greg the Head Scientist and to the South is the Launch Pad.

>talk to greg
"Hi there, I'm Greg the Head Scientist. You must be the new astronaut. I'm very busy right now, but I must tell you what you need to do for your mission to the moon. First you must aquire you space suit."  Greg opens his hand, and in it is the master key.

>talk to greg
Come back to me when you have completed the missions I gave you.

>i
You are carrying:
  a token
  a wrench

>talk to greg
Come back to me when you have completed the missions I gave you.

* * *

>e
Mission Control
A gigantic room filled with rows of monitors, each one manned by an Engineer or Scientist. In the front of the room is a large screen constantly updating with news from all over the world and the status of the mission. In the corner, you spot a trashcan.

At the front of the room looks to be Greg the Head Scientist

To the West is the Storage room, and to the South is the Launch Pad.

>talk to greg
"Hi there, I'm Greg the Head Scientist. You must be the new astronaut. I'm very busy right now, but I must tell you what you need to do for your mission to the moon. First, you must acquire you space suit." Greg opens his hand, and offers you the master key.

>take master key
"Now that you have the key, you can go get your Space Suit and Helmet in storage. Come back to me when you have done that."

>w
Storage Room
A small room filled with a Cage that holds important materials.

There look to be two exits one to the North, and one to the East.

You can see a hatch here.

>unlcok cage with key
That's not a verb I recognise.

>unlock cage with key
You unlock the Cage.

>open cage
You open the Cage, revealing a Space Suit and a Space Helmet.

* * *

>take space suit
Now that you have your space suit you can return to Greg.

>take space helmet
Taken.

>e
Mission Control
A gigantic room filled with rows of monitors, each one manned by an Engineer or Scientist. In the front of the room is a large screen constantly updating with news from all over the world and the status of the mission. In the corner you spot a trash can.

At the front of the room looks to be Greg the Head Scientist

To the West is the Storage room, and to the South is the Launch Pad.

>talk to greg
"Now that you have your space suit and helmet you should go fix the Valve at the Refueling Station outside in the Launch Pad," says Greg.

>s
Launch Pad
As you open the doors from mission control to go outside, you leave the air conditioned building behind. In the distance you see a giant Rocket of immense proportions. It's reflective surface glint beams of sunlight through the air.

Around the launch pad you spot a Refueling Station that looks like it could be used to fuel up the rocket. Running up the side of the metal tower is a Fuel Tube.

The Stairs going up the tower are to the West and Mission Control is to the North.

>fix valve
You fix the valve with your wrench. You feel a rumble under the ground and suddenly with a hiss the rocket fuel starts to flow from the refueling station, to the fuel tube, and to the rocket. In the process, some fuel leaks out and you take it to show to Greg as proof of fixing the valve.

 You seem to have refueled the rocket and should now return to Greg.

>i
You are carrying:
  a fuel glob
  a Space Helmet
  a Space Suit
  a Master Key
  a wrench

>n
Mission Control
A gigantic room filled with rows of monitors, each one manned by an Engineer or Scientist. In the front of the room is a large screen constantly updating with news from all over the world and the status of the mission. In the corner you spot a trash can.

At the front of the room looks to be Greg the Head Scientist

To the West is the Storage room, and to the South is the Launch Pad.

>talk to greg
"Now that you have your space suit and helmet you should go fix the Valve at the Refueling Station outside in the Launch Pad," says Greg.

* * *

>w
Storage Room
A small room filled with a Cage that holds important materials.

There look to be two exits one to the North, and one to the East.

You can see a hatch here.

>unlock cage with key
You unlock the Cage.

* * *

>take space suit
Now that you have your space suit you can return to Greg.

>e
Mission Control
A gigantic room filled with rows of monitors, each one manned by an Engineer or Scientist. In the front of the room is a large screen constantly updating with news from all over the world and the status of the mission. In the corner you spot a trash can.

At the front of the room looks to be Greg the Head Scientist

To the West is the Storage room, and to the South is the Launch Pad.

>talk to greg
"Now that you have your space suit and helmet you should go fix the Valve at the Refueling Station outside in the Launch Pad."
 
 Come back to me when you have completed the missions I gave you.

>s
Launch Pad
As you open the doors from mission control to go outside, you leave the air conditioned building behind. In the distance you see a giant Rocket of immense proportions. It's reflective surface glint beams of sunlight through the air.

Around the launch pad you spot a Refueling Station that looks like it could be used to fuel up the rocket. Running up the side of the metal tower is a Fuel Tube.

The Stairs going up the tower are to the West and Mission Control is to the North.

* * *

>fix valve
You fix the valve with your wrench. You feel a rumble under the ground and suddenly with a hiss the rocket fuel starts to flow from the refueling station, to the fuel tube, and to the rocket. In the process, some fuel leaks out and you take it to show to Greg as proof of fixing the valve.

 You seem to have refueled the rocket and should now return to Greg.

>n
Mission Control
A gigantic room filled with rows of monitors, each one manned by an Engineer or Scientist. In the front of the room is a large screen constantly updating with news from all over the world and the status of the mission. In the corner you spot a trash can.

At the front of the room looks to be Greg the Head Scientist

To the West is the Storage room, and to the South is the Launch Pad.

>talk to greg
"Now that you have your space suit and helmet you should go fix the Valve at the Refueling Station outside in the Launch Pad."
 
 "That was your mission and you completed it perfectly and can move onto the final step.

 You are now ready to go to the rocket. Here is the launch command." Greg opens the hand and offers you the launch command.

>take launch command
"Now go to the loading zone and pull the Launching Lever."

* * *

>s
Launch Pad
As you open the doors from mission control to go outside, you leave the air conditioned building behind. In the distance you see a giant Rocket of immense proportions. It's reflective surface glint beams of sunlight through the air.

Around the launch pad you spot a Refueling Station that looks like it could be used to fuel up the rocket. Running up the side of the metal tower is a Fuel Tube.

The Stairs going up the tower are to the West and Mission Control is to the North.

>w
Stairs
Large wrought iron stairs that look to be the only way Up to the loading zone and back West is the launch pad. On the stairs you see a piece of Shredded Paper.

Taking the stairs looks like it will be good exercise for you legs.

>u
Loading Zone
 A platform at the top of the metal tower. This platform is hundreds of feet in the air, and below you can seen the space base. From up here everything looks so small and the people below look like ants. Across a large gap, you see the rocket, but you cannot get to it yet.

Up here at the Loading Zone you can see a Control Pane which looks like it controls all the rocket's fuel tubes and contains the Launching Lever.

To get back to the Launch Pad use the stairs to go back Down.

>pull launching lever
Now that the rocket is fueled and you are ready to go you are ready to launch. You put your space suit on and walk slowly to the rocket. The Airlock unlocks with a hiss of hydraulics and you step inside. You go up to the flight deck, and strap into your seat and get ready to launch.

  5.  4.  3.  2.  1.  We have liftoff…

 You suddenly feel the thrusters engage and the rocket starts to blast off with an ear shattering roar. The rocket starts to move faster and faster, and it feels like the skin on your face is being pulled back because of the force. As the ship rattles you hear a voice over the loudspeaker. "Detaching Rockets"
 The shuttle detaches from the rocket, and you have finally reached space.
 
Flight Deck
At the head of the Space Shuttle is the flight deck where the entirety of the ship is controlled. You see one seat for you since you are the only one on the Mission.

In front of the seats is a thick Windscreen the protects you from outer space and allows you to see out the front so you can pilot the ship and use the Controls to the space shuttle.

Below the Flight Deck is the Crew Compartment.

>down
Crew Compartment
You step inside the Space Shuttle to the Crew Compartment the place where spend most of your time living and working on your voyage. You can see your way through the metal room with the fluorescent lights illuminating your way. You now stand on one of the walls of the space shuttle, as there is no gravity.

In the Crew Compartment you spot some beds and some storage Cabinets.

Below you in the Space Shuttle is the Lower Deck, Above you is the Flight Deck, and leading West is the Airlock which you will need to pass through to get to space.

>open cabinet
In the cabinet, you see a flag, vodka, and a shovel.

>take shovel
Taken.

>take flag
As you look at the flag you realize you are not an American Astronaut, but a Russian one. You suddenly remember some of  the details of your mission. Go to the moon, claim it for the Motherland, and destroy all traces of the Americans.

>w
Airlock
A room that separates space from the inner space ship. East of the Airlock is Outer Space and West of the Airlock is the Crew Compartment.

With a hiss of hydraulics and pressure one side of the Airlock closes and the other opens.

>w
OuterSpace
You float in space after leaving the shuttle and stare at the emptiness of space. Floating in space with you is a piece of Folded Paper.

You remember a quote you once heard from a movie. "In space, no one can hear you scream.  You cannot hear anything except the crackle of your headset telling you to complete you mission by landing on the moon Below. Back West is the Airlock."

>d
Moon Surface
A large expanse of land in space with gigantic craters strewn across the surface. You see the footprints of previous moon expeditions and across the way you see the American flag. Above you is OuterSpace.

You also see a Hole in the ground that you might be able to open.

>open hole
You dig a hole in the moon with your shovel, which looks like the russian Flag can go in it.

>put flag in hole
(the Flag in Hole)

 You put the flag of the motherland in the hole and claim the Moon FOR RUSSIA!!! 

 Now that your mission is complete you radio back to mission control. "Thank you for your service to the Country. Your sacrifice will be remembered," says mission control over the radio.

 Remembered? I'm not dead yet.

 Suddenly, you have a hard time breathing, your oxygen supply seems to be depleting.  BOOM!  The space shuttle explodes behind you.

 In your last moments, you finally remember the mission details. 

 To go to the moon and plant Russia's flag. After completing your mission, your life will then be terminated as your use has ended… 摡潩戠捡⁫潴洠獩楳湯挠湯牴汯‮吢慨歮礠畯映牯礠畯⁲敳 you have a hard time breathing, your oxygen supply se
 

    *** You have won ***

In that game you scored 0 out of a possible 55, in 32 turns.

Would you like to RESTART, RESTORE a saved game, QUIT or UNDO the last command?

* * *

>talk to greg
"Hi there, I'm Greg the Head Scientist. You must be the new astronaut. I'm very busy right now, but I must tell you what you need to do for your mission to the moon. First, you must acquire you space suit." Greg opens his hand, and offers you the master key.

>x trashcan
A plain plastic trash can. Inside it you can see a piece of Ripped Paper.

>take ripped paper
You can't see any such thing.

* * *

>x utility closet
A closet used for storing things to keep the bathroom in working order.

[Your score has just gone up by one point.]

>open closet
You open the utility closet and reveal some chemicals and a Wrench.

>take chemicals
Taken.

>x chemicals
You smell a strong stench of cleaning chemicals used to clean up the barf of the astronauts after they get of the centrifuge.

[Your score has just gone up by one point.]

>look
Bathroom
A spotless tiled restroom with many stalls and a large spanning mirror along the wall. It seems very peaceful here. In the back of the room you see a Utility Closet that looks to be used by the Janitor.

The exit to the Bathroom is to the East.

>x stall
A tall white stall which holds a toilet and a roll of double ply Charmin ultra soft. Even though it is very clean in the stall, on the door you see some graffiti.

In the Stall you also see a toilet.

[Your score has just gone up by one point.]

>x toilet
A white porcelain toilet. In the toilet is some barf.

[Your score has just gone up by one point.]

>sit in toilet
You get onto the Toilet.

>x barf
Human bile in the toilet. Gross.

[Your score has just gone up by one point.]

>take bard
You can't see any such thing.

>take barf
Gross. Why would you do that?

    *** You have died ***

In that game you scored 5 out of a possible 55, in 10 turns.

Would you like to RESTART, RESTORE a saved game, QUIT or UNDO the last command?

* * *

>open closed
You can't see any such thing.

>open closet
You open the utility closet, revealing a chemicals and a wrench.

>take chemicals
Taken.

>take wrench
Taken.

>e
Training Room
In the training room you see a giant spinning Centrifuge in the middle of the room.

Getting in the Centrifuge is a tequired of an astronaut, and might take a few times to do correctly.

The bathroom is to the West, and the storage room is to the South.

You can see a partition here.

>get in centrifuge
You get into the centrifuge and it spins round and round until your stomache feels like it is going to bust open. You get very quezzy and feel like you almost want to barf.

 Finally, the spinning stops, and you get out of the centrifuge.  You hear the click of the Partition unlocking.

>s
(first opening the partition)

Storage Room
A small room filled with Space Suits and Space Helmets hung on the wall behind a Cage.

There look to be two exits one to the North, and one to the East.

You can see a partition and a Cage (closed) here.

>e
Mission Control
A gigantic room filled with rows of moniters, each one manned by an Engineer or Scientist. In the front of the room is a large sceen constantly updating with news from all over the world and the status of the mission.

At the front of the room looks to be Greg the Head Scientist and to the South is the Launch Pad.

>take key
Taken.

>n
You can't go that way.

>w
Storage Room
A small room filled with Space Suits and Space Helmets hung on the wall behind a Cage.

There look to be two exits one to the North, and one to the East.

You can see a partition and a Cage (closed) here.

>unlock cage
What do you want to unlock the Cage with?

>key
You unlock the Cage.

>open cage
You open the Cage, revealing a Space Suit and a Space Helmet.

>take space suit
Taken.

>take space helmet
Taken.

>e
Mission Control
A gigantic room filled with rows of moniters, each one manned by an Engineer or Scientist. In the front of the room is a large sceen constantly updating with news from all over the world and the status of the mission.

At the front of the room looks to be Greg the Head Scientist and to the South is the Launch Pad.

>take launch command
Taken.

>s
Launch Pad
As you open the doors from mission control to go outside, you leave the airconditioned building behind. In the distance you see a giant Rocket of immense propotions. It's reflective surface glint beams of sunlight through the air.

Around the launch pad you spot a Refuelling Station that looks like it could be used to fill up the rocket. Connected to the rocket is a metal tower with a Elevator which looks like it could be used to get to the Loading zone. Running up the side of the metal tower is a Fuel Tube.

The Stairs are to the West.

>w
Stairs
Large wrought iron stairs that look to be the only way Up to the loading zone. It looks like it will be good exercise.

>up
Loading Zone
 A platform at the top of the metal tower. This platform is hundreds of feet in the air, and below you can seen the space base. From up here everything looks so small and the people below look like ants.

Across a large gap you see the rocket, but you cannont get to it yet.

Up here at the Loading Zone you can see a Control Pane which looks like it controls all the rocket's fuel tubes as well as the launch mecanism.

To get back to the Launch Pad use the stairs to go back down. 

You can see a Control Pane and an Air Lock here.

>x fuel tubes
You can't see any such thing.

>x launch mecanism
The action that starts the launch of the rocket

>x control pane
On the control pane, you see the Docking Lever that controls the launch of the ship.

>pull docking lever
 Now that the rocket is fueled and you are ready to go you are ready to launch. You put your space suit on and walk slowly to the rocket. The Airlock unlocks with a hiss of hydraulics and you step inside. You go up to the flight deck, and strap into your seat and get ready to launch.
  5.  4.  3.  2.  1.  We have liftoff...
 You suddenly feel the thrusters engage and the rocket starts to blast off with an ear shattering roar. The rocket starts to move faster and faster, and it feels like the skin on your face is being pulled back because of the force. As the ship rattles you hear a voice over the loudspeaker. "Detaching Rockets"
 The shuttle detaches from the rocket, and you have finally reached space
 
Flight Deck
At the head of the Space Shuttle is the flight deck where the entirety of the ship is controlled. You see three seats, one for the captain, one for the engineer, and one for you.

In front of the seats is a thick Windsceen the protects you from outer space and allows you to see out the front so you can see out of the ship, and the Controls to the space shuttles.

>down
Crew Compartment
You step inside the Space Shuttle to the Crew Compartment the place where spend most of your time living and working on your voyage. You can see your way through the metal room with the fluroscent lights illuminating your way. You now stand on one of the walls of the space shuttle, as it is now pointed upwards towards the atomsphere, and will change orientation when reaching the correct altitude.

In the Crew Compartment you spot some Beds, a Work Bench, and some storage Cabinets. Below you in the Space Shuttle is the Lower Deck, and Above you is the Flight Deck. 

You can see a Cabinets (in which is a Shovel) here.

>x lights
You can't see any such thing.

>open cabinet
That's already open.

>take shovel
Taken.

>e
You can't go that way.

>w
Airlock
A room that seperate the outside from the inner space ship.

>e
Crew Compartment
You step inside the Space Shuttle to the Crew Compartment the place where spend most of your time living and working on your voyage. You can see your way through the metal room with the fluroscent lights illuminating your way. You now stand on one of the walls of the space shuttle, as it is now pointed upwards towards the atomsphere, and will change orientation when reaching the correct altitude.

In the Crew Compartment you spot some Beds, a Work Bench, and some storage Cabinets. Below you in the Space Shuttle is the Lower Deck, and Above you is the Flight Deck. 

You can see a Cabinets (empty) here.

>w
Airlock
A room that seperate the outside from the inner space ship.

I beg your pardon?

>w
OuterSpace
You float in space after leaving the shuttle and stare at the emptiness of space. You cannont hear anything except the crackle of your headset telling you to complete you mission.

You remember a quote you once heard from a movie.  "In space, no one can hear you scream. "

>down
Moon Surface
A large expanse of land in space with giagantic craters strew across the surface. You see the footprints of previous moon expeditions and across the way you see the American flag.

You also see a hole that looks partially filled up. If you had a shovel you might dig it up.

>dig hole
I only understood you as far as wanting to dig.

>open hole
You can't see any such thing.

>dig the hole
I only understood you as far as wanting to dig.

>dig
You must supply a noun.

* * *

>xyzzy
Monkeys are tasty.